abcdefghijklmnopqrstuvwxyz	abcdefghijklmnopqrstuvwxyz/SL
세계청소년선수권대회	세계/NNG + 청소년/NNG + 선수권/NNG + 대회/NNG
한일월드컵조직위원장	한일/NNP + 월드컵/NNG + 조직/NNG + 위원장/NNG
금당쌍탑식가람배치	금당/NNG + 쌍/NNG + 탑식/NNG + 가람/NNG + 배치/NNG
금당일탑식가람배치	금당/NNG + 일탑식/NNG + 가람/NNG + 배치/NNG
자조정감독그룹회의	자/NNG + 조정/NNG + 감독/NNG + 그룹/NNG + 회의/NNG
금당일탑식가람지	금당/NNG + 일탑식/NNG + 가람지/NNG
컨페더레이션스컵	컨페더레이션스/NNG + 컵/NNG
금당쌍탑식가람	금당/NNG + 쌍/NNG + 탑식/NNG + 가람/NNG
금당일탑식가람	금당/NNG + 일탑식/NNG + 가람/NNG
금당일탑식배치	금당/NNG + 일탑식/NNG + 배치/NNG
뉴크레오타이드	뉴크레오타이드/NNG
당원내총무회담	당/NNG + 원내/NNG + 총무/NNG + 회담/NNG
백밀리리터들이	백/NR + 밀리리터들이/NNG
비즈니스전용기	비즈니스/NNG + 전용기/NNG
억싱가포르달러	억/NR + 싱가포르/NNP + 달러/NNB
인유권자위원회	인/NNG + 유권자/NNG + 위원회/NNG
정책조정위원장	정책/NNG + 조정/NNG + 위원장/NNG
파운드짜리폭탄	파운드/NNB + 짜리/XSN + 폭탄/NNG
S커뮤니케이션	S/SL + 커뮤니케이션/NNG
마이크로그램	마이크로그램/NNB
마이크로미터	마이크로미터/NNB
강플레이오프	강/NNG + 플레이오프/NNG
개년계획기간	개년/NNB + 계획/NNG + 기간/NNG
메가바이트당	메가바이트/NNG + 당/XSN
메가와트짜리	메가와트/NNG + 짜리/XSN
가구설문조사	가구/NNG + 설문/NNG + 조사/NNG
백기가bps	백/NR + 기가/NNG + bps/SL
백여만원어치	백/NR + 여/XSN + 만/NR + 원/NNB + 어치/NNG
백주년기념관	백/NR + 주년/NNB + 기념관/NNG
공중강습사단	공중/NNG + 강습/NNG + 사단/NNG
성조정위원회	성/NNG + 조정/NNG + 위원회/NNG
아테네올림픽	아테네/NNP + 올림픽/NNG
억스위스프랑	억/NR + 스위스/NNP + 프랑/NNB
여자프로농구	여자/NNG + 프로/NNG + 농구/NNG
월물가상승률	월/NNB + 물가/NNG + 상승/NNG + 률/XSN
응급정보센터	응급/NNG + 정보/NNG + 센터/NNG
제곱센티미터	제곱센티미터/NNB
제곱킬로미터	제곱/NNG + 킬로미터/NNB
주기추모사업	주기/NNB + 추모/NNG + 사업/NNG
차대전중나치	차/NNB + 대전/NNG + 중/NNB + 나치/NNP
천만달러짜리	천만/NR + 달러/NNB + 짜리/XSN
천만여원어치	천만/NR + 여/XSN + 원/NNB + 어치/NNG
천여만원어치	천/NR + 여/XSN + 만/NR + 원/NNB + 어치/NNG
킬로그램짜리	킬로그램/NNB + 짜리/XSN
킬로미터가량	킬로미터/NNB + 가량/NNG
프랑스월드컵	프랑스/NNP + 월드컵/NNG
한국드림리그	한국/NNP + 드림/NNG + 리그/NNG
D애니메이션	D/SL + 애니메이션/NNG
라운드짜리	라운드/NNG + 짜리/XSN
마이크로g	마이크로/NNG + g/SL
년미만짜리	년/NNB + 미만/NNG + 짜리/XSN
년사업연도	년/NNB + 사업/NNG + 연도/NNG
개국위원회	개국/NNB + 위원회/NNG
개국제공항	개/NNB + 국제공항/NNG
단지관리소	단지/NNG + 관리소/NNG
개년계획상	개년/NNB + 계획/NNG + 상/XSN
공비리수사	공/NNG + 비리/NNG + 수사/NNG
공비리진상	공/NNG + 비리/NNG + 진상/NNG
共비리척결	共/SH + 비리/NNG + 척결/NNG
만군중대회	만/NR + 군중대회/NNG
만달러돌파	만/NR + 달러/NNB + 돌파/NNG
만달러어치	만/NR + 달러/NNB + 어치/NNG
만마일리지	만/NR + 마일리지/NNG
만여개업체	만/NR + 여/XSN + 개/NNB + 업체/NNG
만여원어치	만/NR + 여/XSN + 원/NNB + 어치/NNG
만원권수표	만/NR + 원/NNB + 권/NNG + 수표/NNG
만호주달러	만/NR + 호주/NNP + 달러/NNG
메가바이트	메가바이트/NNB
메가바이트	메가바이트/NNG
메가헤르츠	메가헤르츠/NNG
미국월드컵	미국월드컵/NNP
밀리리터당	밀리리터/NNB + 당/XSN
밀리미터쯤	밀리미터/NNB + 쯤/XSN
방범순찰대	방범/NNG + 순찰대/NNG
당대표회담	당/NNG + 대표/NNG + 회담/NNG
당연립체제	당/NNG + 연립/NNG + 체제/NNG
당총무협상	당/NNG + 총무/NNG + 협상/NNG
백달러이상	백/NR + 달러/NNB + 이상/NNG
백만원어치	백만/NR + 원/NNB + 어치/NNG
백만원이상	백만/NR + 원/NNB + 이상/NNG
백만원짜리	백만/NR + 원/NNB + 짜리/XSN
백만크로네	백만/NR + 크로네/NNG
백만파운드	백만/NR + 파운드/NNB
백억마르크	백억/NR + 마르크/NNG
백억원어치	백억/NR + 원/NNB + 어치/NNG
백여m가량	백/NR + 여/XSN + m/SL + 가량/NNG
백m달리기	백/NR + m/SL + 달리기/NNG
백ml짜리	백/NR + ml/SL + 짜리/XSN
백MW규모	백/NR + MW/SL + 규모/NNG
베니스건축	베니스/NNP + 건축/NNG
부대책임자	부대/NNG + 책임자/NNG
비트컴퓨터	비트/NNB + 컴퓨터/NNG
비트플레인	비트플레인/NNG
서울올림픽	서울/NNP + 올림픽/NNG
세기위원회	세기/NNG + 위원회/NNG
세기폭스사	세기/NNG + 폭스사/NNP
센티미터씩	센티미터/NNB + 씩/XSN
센티미터쯤	센티미터/NNB + 쯤/XSN
스위스프랑	스위스/NNP + 프랑/NNB
스타디온안	스타디온/NNG + 안/NNG
시간여가량	시간/NNB + 여/XSN + 가량/NNG
시그마제도	시그마/NNG + 제도/NNG
아시안게임	아시안/NNG + 게임/NNG
공화국비리	공화국/NNG + 비리/NNG
각형기단지	각형/NNG + 기단지/NNG
대감시대상	대/NNG + 감시/NNG + 대상/NNG
大經濟問題	大經濟問題/SH
개월여동안	개월/NNB + 여/XSN + 동안/NNG
國軍事同盟	國軍事同盟/SH
군부사령관	군/NNG + 부사령관/NNG
억달러규모	억/NR + 달러/NNB + 규모/NNG
억달러어치	억/NR + 달러/NNB + 어치/NNG
억달러짜리	억/NR + 달러/NNB + 짜리/XSN
억여원가량	억/NR + 여/XSN + 원/NNB + 가량/NNG
억여원어치	억/NR + 여/XSN + 원/NNB + 어치/NNG
억즈워티씩	억/NR + 즈워티/NNB + 씩/XSN
억홍콩달러	억/NR + 홍콩/NNP + 달러/NNG
여든일곱살	여든/NR + 일곱/NR + 살/NNB
여만원어치	여/XSN + 만/NR + 원/NNB + 어치/NNG
여명이상씩	여/XSN + 명/NNB + 이상/NNG + 씩/XSN
여억원어치	여/XSN + 억/NR + 원/NNB + 어치/NNG
여킬로미터	여/XSN + 킬로미터/NNB
우리은행배	우리은행/NNP + 배/NNG
원이하형때	원/NNB + 이하/NNG + 형/NNG + 때/NNG
월결산기업	월/NNB + 결산/NNG + 기업/NNG
월유엔총회	월/NNB + 유엔총회/NNP
월임시국회	월/NNB + 임시/NNG + 국회/NNG
월전당대회	월/NNB + 전당/NNG + 대회/NNG
월전역조처	월/NNB + 전역/NNG + 조처/NNG
음성사서함	음성/NNG + 사서함/NNG
인지배체제	인/NNG + 지배/NNG + 체제/NNG
인터내셔널	인터내셔널/NNG
대불가사의	대/NNG + 불가사의/NNG
자유학예과	자유/NNG + 학예/NNG + 과/NNG
제곱미터쯤	제곱미터/NNB + 쯤/XSN
제곱인치당	제곱/NNG + 인치/NNB + 당/XSN
금당일탑식	금당/NNG + 일탑식/NNG
기가바이트	기가바이트/NNB
기가헤르츠	기가/NNG + 헤르츠/NNB
조정위원장	조정/NNG + 위원장/NNG
주년기념관	주년/NNB + 기념관/NNG
중추돌사고	중/NNG + 추돌/NNG + 사고/NNG
차공천작업	차/NNB + 공천/NNG + 작업/NNG
차금속산업	차/NNB + 금속/NNG + 산업/NNG
차단체협상	차/NNB + 단체/NNG + 협상/NNG
차분담금중	차/NNB + 분담금/NNG + 중/NNB
차세계대전	차/NNB + 세계/NNG + 대전/NNG
차신경활성	차/NNB + 신경/NNG + 활성/NNG
차의료기관	차/NNB + 의료/NNG + 기관/NNG
차진료기능	차/NNB + 진료/NNG + 기능/NNG
대총선대책	대/NNB + 총선/NNG + 대책/NNG
도연합의병	도/NNG + 연합/NNG + 의병/NNG
가구1주택	가구/NNG + 1/SN + 주택/NNG
천달러짜리	천/NR + 달러/NNB + 짜리/XSN
천리엘짜리	천/NR + 리엘/NNB + 짜리/XSN
천만원어치	천만/NR + 원/NNB + 어치/NNG
천만원요구	천만/NR + 원/NNB + 요구/NNG
천만원정도	천만/NR + 원/NNB + 정도/NNG
천만원짜리	천만/NR + 원/NNB + 짜리/XSN
천억원어치	천억/NR + 원/NNB + 어치/NNG
천여만원씩	천/NR + 여/XSN + 만/NR + 원/NNB + 씩/XSN
천km이하	천/NR + km/SL + 이하/NNG
추진협의회	추진/NNG + 협의회/NNG
층지창책장	층/NNG + 지창/NNG + 책장/NNG
치안서비스	치안/NNG + 서비스/NNG
캐나다달러	캐나다/NNP + 달러/NNB
킬로그램당	킬로그램/NNB + 당/XSN
킬로그램쯤	킬로그램/NNB + 쯤/XSN
킬로미터씩	킬로미터/NNB + 씩/XSN
킬로미터쯤	킬로미터/NNB + 쯤/XSN
킬로바이트	킬로바이트/NNB
킬로칼로리	킬로칼로리/NNB
타수1안타	타수/NNG + 1/SN + 안타/NNG
파운드짜리	파운드/NNB + 짜리/XSN
퍼센트가량	퍼센트/NNB + 가량/NNG
페이지짜리	페이지/NNG + 짜리/XSN
평방미터당	평방미터/NNB + 당/XSN
프레임짜리	프레임/NNG + 짜리/XSN
한일월드컵	한일/NNP + 월드컵/NNG
함대사령관	함대/NNG + 사령관/NNG
함대사령부	함대/NNG + 사령부/NNG
헥토파스칼	헥토파스칼/NNG
회생일파티	회/NNB + 생일/NNG + 파티/NNG
being	being/SL
D業種忌避	D/SL + 業種忌避/SH
TV코리아	TV/SL + 코리아/NNP
units	units/SL
wtour	wtour/SL
달러어치	달러/NNB + 어치/NNG
달러짜리	달러/NNB + 짜리/XSN
공비자금	공/NNG + 비자금/NNG
만냥짜리	만/NR + 냥/NNB + 짜리/XSN
만년전경	만/NR + 년/NNB + 전/NNG + 경/XSN
만루피아	만/NR + 루피아/NNB
만마르크	만/NR + 마르크/NNB
만배럴씩	만/NR + 배럴/NNB + 씩/XSN
만상자씩	만/NR + 상자/NNG + 씩/XSN
만세시위	만세/NNG + 시위/NNG
만에이커	만/NR + 에이커/NNB
만여건씩	만/NR + 여/XSN + 건/NNB + 씩/XSN
만여마리	만/NR + 여/XSN + 마리/NNB
만여명線	만/NR + 여/XSN + 명/NNB + 線/SH
만여Km	만/NR + 여/XSN + Km/SL
만원가량	만/NR + 원/NNB + 가량/NNG
마지기당	마지기/NNB + 당/XSN
만원어치	만/NR + 원/NNB + 어치/NNG
만원이상	만/NR + 원/NNB + 이상/NNG
만원정도	만/NR + 원/NNB + 정도/NNG
만원짜리	만/NR + 원/NNB + 짜리/XSN
만케이스	만/NR + 케이스/NNG
만파운드	만/NR + 파운드/NNB
만평규모	만/NR + 평/NNB + 규모/NNG
만평짜리	만/NR + 평/NNB + 짜리/XSN
만포인트	만/NR + 포인트/NNG
마지기반	마지기/NNB + 반/NNG
만CGT	만/NR + CGT/SL
만kw급	만/NR + kw/SL + 급/NNG
마지기씩	마지기/NNB + 씩/XSN
메가와트	메가와트/NNG
명가운데	명/NNB + 가운데/NNG
명정도씩	명/NNB + 정도/NNG + 씩/XSN
모작지대	모작/NNG + 지대/NNG
미터짜리	미터/NNB + 짜리/XSN
밀리그램	밀리그램/NNB
밀리리터	밀리리터/NNG
밀리미터	밀리미터/NNB
반세기여	반세기/NNG + 여/XSN
등항해사	등/NNB + 항해사/NNG
결합원칙	결합/NNG + 원칙/NNG
년간이란	년/NNB + 간/NNG + 이란/NNP
당연립틀	당/NNG + 연립/NNG + 틀/NNG
경기연속	경기/NNG + 연속/NNG
당총재간	당/NNG + 총재/NNG + 간/NNB
경비단장	경비/NNG + 단장/NNG
로케트탄	로케트탄/NNG
공정권때	공/NNG + 정권/NNG + 때/NNG
롯데월드	롯데월드/NNP
공정권하	공/NNG + 정권하/NNG
년대이래	년대/NNB + 이래/NNB
백기이하	백/NR + 기/NNB + 이하/NNG
백년동안	백/NR + 년/NNB + 동안/NNG
백대기업	백/NR + 대/XSN + 기업/NNG
백마리씩	백/NR + 마리/NNP + 씩/XSN
백만가지	백만/NR + 가지/NNB
백만개쯤	백만/NR + 개/NNB + 쯤/XSN
백만달러	백만/NR + 달러/NNB
百萬달러	百萬/SH + 달러/NNB
백만여원	백만/NR + 여/XSN + 원/NNB
백만여주	백만/NR + 여/XSN + 주/NNG
백만원대	백만/NR + 원/NNB + 대/XSN
백만원선	백만/NR + 원/NNB + 선/NNG
백만원씩	백만/NR + 원/NNB + 씩/XSN
백만원쯤	백만/NR + 원/NNB + 쯤/XSN
경찰서측	경찰서/NNG + 측/NNB
백명가량	백/NR + 명/NNB + 가량/NNG
백명이상	백/NR + 명/NNB + 이상/NNG
백명정도	백/NR + 명/NNB + 정도/NNG
백살짜리	백/NR + 살/NNB + 짜리/XSN
백억달러	백억/NR + 달러/NNB
백억여원	백억/NR + 여/XSN + 원/NNB
백억원대	백억/NR + 원/NNB + 대/XSN
백억원씩	백억/NR + 원/NNB + 씩/XSN
백억원중	백억/NR + 원/NNB + 중/NNB
백여가구	백/NR + 여/XSN + 가구/NNG
백여가지	백/NR + 여/XSN + 가지/NNB
백여개국	백/NR + 여/XSN + 개국/NNB
백여개씩	백/NR + 여/XSN + 개/NNB + 씩/XSN
백여년간	백/NR + 여/XSN + 년/NNB + 간/NNG
백여만명	백/NR + 여/XSN + 만/NR + 명/NNB
백여만병	백/NR + 여/XSN + 만/NR + 병/NNG
백여만섬	백/NR + 여/XSN + 만/NR + 섬/NNB
백여만원	백/NR + 여/XSN + 만/NR + 원/NNB
백여만주	백/NR + 여/XSN + 만/NR + 주/NNG
백여명씩	백/NR + 여/XSN + 명/NNB + 씩/XSN
백여미터	백/NR + 여/XSN + 미터/NNB
백여세대	백/NR + 여/XSN + 세대/NNG
백여시간	백/NR + 여/XSN + 시간/NNG
백여억원	백/NR + 여/XSN + 억/NR + 원/NNB
백여업체	백/NR + 여/XSN + 업체/NNG
백여주민	백/NR + 여/XSN + 주민/NNG
백여통씩	백/NR + 여/XSN + 통/NNB + 씩/XSN
백여편씩	백/NR + 여/XSN + 편/NNB + 씩/XSN
백여표차	백/NR + 여/XSN + 표/NNG + 차/NNG
백여Km	백/NR + 여/XSN + Km/SL
백여m쯤	백/NR + 여/XSN + m/SL + 쯤/XSN
백원짜리	백/NR + 원/NNB + 짜리/XSN
백쪽짜리	백/NR + 쪽/NNG + 짜리/XSN
백파운드	백/NR + 파운드/NNB
백회선분	백/NR + 회선/NNG + 분/XSN
백g짜리	백/NR + g/SL + 짜리/XSN
백m가량	백/NR + m/SL + 가량/NNG
백m정도	백/NR + m/SL + 정도/NNG
백ppm	백/NR + ppm/SL
번아이언	번/NNB + 아이언/NNG
베르스타	베르스타/NNP
부소매옷	부/NNB + 소매/NNG + 옷/NNG
부속실장	부속/NNG + 실장/NNG
불병좌상	불병좌상/NNG
비트머쉰	비트/NNB + 머쉰/NNG
비트짜리	비트/NNB + 짜리/XSN
빙하시대	빙하/NNG + 시대/NNG
사업연도	사업/NNG + 연도/NNG
사회정의	사회/NNG + 정의/NNG
살어린이	살/NNB + 어린이/NNG
서른여섯	서른여섯/NR
선개헌안	선/NNG + 개헌안/NNG
성실주의	성실/NNG + 주의/NNG
세기동안	세기/NNG + 동안/NNG
세기말경	세기말/NNG + 경/XSN
세기말엽	세기/NNG + 말엽/NNG
세기말쯤	세기말/NNG + 쯤/XSN
세기북스	세기/NNG + 북스/NNG
세기이래	세기/NNG + 이래/NNB
세기이후	세기/NNG + 이후/NNG
세기초엽	세기/NNG + 초엽/NNG
세기폭스	세기/NNG + 폭스/NNG
세기화랑	세기/NNG + 화랑/NNG
세대위성	세대/NNG + 위성/NNG
세부항목	세부/NNG + 항목/NNG
세종오픈	세종/NNP + 오픈/NNG
센트짜리	센트/NNB + 짜리/XSN
센티미터	센티미터/NNB
소로첨차	소로/NNG + 첨차/NNG
스물일곱	스물일곱/NR
스타디온	스타디온/NNG
개비짜리	개비/NNG + 짜리/XSN
개사업장	개/NNB + 사업장/NNG
시간가량	시간가량/NNG
시간동안	시간/NNB + 동안/NNG
시간만인	시간/NNB + 만인/NNG
시간여만	시간/NNB + 여/XSN + 만/NNB
시간여전	시간/NNB + 여/XSN + 전/NNG
시간이내	시간/NNB + 이내/NNG
시간정도	시간/NNB + 정도/NNG
시간정도	시간/NNG + 정도/NNG
시간짜리	시간/NNB + 짜리/XSN
시간짜리	시간/NNG + 짜리/XSN
식량수급	식량/NNG + 수급/NNG
심구형량	심/NNG + 구형량/NNG
십구호실	십구/NR + 호실/NNG
쎈트짜리	쎈트/NNB + 짜리/XSN
쎈티미터	쎈티미터/NNB
씩하나씩	씩/XSN + 하나/NR + 씩/XSN
아나운서	아나운서/NNG
아시안컵	아시안/NNG + 컵/NNG
아홉번째	아홉/NR + 번/NNB + 째/XSN
애틀랜타	애틀랜타/NNP
야드짜리	야드/NNG + 짜리/XSN
어시스트	어시스트/NNG
공화국때	공화국/NNG + 때/NNG
공화국말	공화국/NNG + 말/NNB
공화국하	공화국하/NNG
각천장층	각/NNG + 천장/NNG + 층/NNG
가입세대	가입/NNG + 세대/NNG
교구본사	교구/NNG + 본사/NNG
개영화제	개/NNB + 영화제/NNG
개월가량	개월/NNB + 가량/NNG
개월과정	개월/NNB + 과정/NNG
개월동안	개월/NNB + 동안/NNG
구조대원	구조대원/NNG
개월여만	개월/NNB + 여/XSN + 만/NNB
고등법원	고등/NNG + 법원/NNG
개월이상	개월/NNB + 이상/NNG
고등학교	고등학교/NNG
대대통령	대/NNB + 대통령/NNG
개월짜리	개월/NNB + 짜리/XSN
대메이저	대/NNG + 메이저/NNG
개위원회	개/NNB + 위원회/NNG
고속도로	고속도로/NNG
군단요원	군단/NNG + 요원/NNG
군사령관	군사령관/NNG
군사령부	군사령부/NNG
억달러대	억/NR + 달러/NNB + 대/XSN
억달러씩	억/NR + 달러/NNB + 씩/XSN
년임기제	년/NNB + 임기/NNG + 제/XSN
억달러쯤	억/NR + 달러/NNB + 쯤/XSN
억미달러	억/NR + 미/NNP + 달러/NNB
군사학교	군사학교/NNG
억여달러	억/NR + 여/XSN + 달러/NNB
억여원중	억/NR + 여/XSN + 원/NNB + 중/NNB
억원가량	억/NR + 원/NNB + 가량/NNG
억원규모	억/NR + 원/NNB + 규모/NNG
억원상당	억/NR + 원/NNB + 상당/NNG
억원어치	억/NR + 원/NNB + 어치/NNG
억원짜리	억/NR + 원/NNB + 짜리/XSN
억파운드	억/NR + 파운드/NNB
억t짜리	억/NR + t/SL + 짜리/XSN
여개노조	여/XSN + 개/NNB + 노조/NNG
여개업체	여/XSN + 개/NNB + 업체/NNG
여드렛날	여드렛날/NNG
여든일곱	여든/NR + 일곱/NR
여만달러	여/XSN + 만/NR + 달러/NNB
여만원선	여/XSN + 만/NR + 원/NNB + 선/NNG
여만원씩	여/XSN + 만/NR + 원/NNB + 씩/XSN
여명끼리	여/XSN + 명/NNB + 끼리/XSN
여분동안	여/XSN + 분/NNB + 동안/NNG
여섯번째	여섯/NR + 번/NNB + 째/XSN
여억원대	여/XSN + 억/NR + 원/NNB + 대/XSN
여쪽짜리	여/XSN + 쪽/NNG + 짜리/XSN
년제대학	년/NNB + 제/XSN + 대학/NNG
여통이상	여/XSN + 통/NNG + 이상/NNG
여m가량	여/XSN + m/SL + 가량/NNG
여m아래	여/XSN + m/SL + 아래/NNG
연방법원	연방/NNG + 법원/NNG
연속경기	연속/NNG + 경기/NNG
열번째쯤	열/NR + 번/NNB + 째/XSN + 쯤/NNG
예순다섯	예순다섯/NR
예순일곱	예순/NR + 일곱/NR
오라비네	오라비/NNG + 네/XSN
오륙백원	오/NR + 륙백/NR + 원/NNB
와트짜리	와트/NNB + 짜리/XSN
월음악제	월/NNB + 음악제/NNG
大分斷國	大分斷國/SH
응급체계	응급/NNG + 체계/NNG
이산가족	이산가족/NNG
인위원회	인/NNG + 위원회/NNG
가마니쯤	가마니/NNG + 쯤/XSN
인치짜리	인치/NNB + 짜리/XSN
인터셉트	인터셉트/NNG
일간구금	일/NNB + 간/NNG + 구금/NNG
일고여덟	일고여덟/NR
년초이래	년/NNB + 초/NNB + 이래/NNB
일생활권	일/NNB + 생활/NNG + 권/XSN
일용산구	일/NNB + 용산구/NNP
일쯤국회	일/NNB + 쯤/XSN + 국회/NNG
임투승리	임투/NNG + 승리/NNG
자격인증	자격/NNG + 인증/NNG
장가운데	장/NNG + 가운데/NNG
점대짜리	점/NNB + 대/XSN + 짜리/XSN
정규리그	정규/NNG + 리그/NNG
정보센터	정보/NNG + 센터/NNG
제곱미터	제곱미터/NNB
제곱미터	제곱미터/NNG
제곱피트	제곱/NNG + 피트/NNB
그램짜리	그램/NNB + 짜리/XSN
그루가량	그루/NNB + 가량/NNG
대수습책	대/NNG + 수습책/NNG
가지이상	가지/NNB + 이상/NNG
대여섯쯤	대여섯/NR + 쯤/XSN
급군구중	급/NNG + 군구/NNG + 중/NNB
급자격증	급/NNG + 자격증/NNG
급장애인	급/NNG + 장애인/NNG
급장해시	급/NNG + 장해/NNG + 시/NNB
개지구당	개/NNB + 지구당/NNG
기본부문	기본/NNG + 부문/NNG
꼬챙이씩	꼬챙이/NNG + 씩/XSN
나노미터	나노미터/NNB
조바이트	조/NR + 바이트/NNB
조원어치	조/NR + 원/NNB + 어치/NNG
조원이상	조/NR + 원/NNB + 이상/NNG
조원투자	조/NR + 원/NNB + 투자/NNG
주년기념	주년/NNB + 기념/NNG
주년회견	주년/NNB + 회견/NNG
주일동안	주일/NNB + 동안/NNG
주일이상	주일/NNB + 이상/NNG
지선다형	지/NNB + 선다/NNG + 형/XSN
차공천자	차/NNB + 공천자/NNG
차대의원	차/NNB + 대의원/NNG
차대전때	차/NNB + 대전/NNG + 때/NNG
차대전중	차/NNB + 대전/NNG + 중/NNB
차대전후	차/NNB + 대전/NNG + 후/NNG
차방정식	차/NNB + 방정식/NNG
차선도로	차선/NNG + 도로/NNG
차신경통	차/NNB + 신경통/NNG
평4량식	평/NNG + 4/SN + 량/NNB + 식/NNG
차신경핵	차/NNB + 신경핵/NNG
차아파트	차/NNB + 아파트/NNG
次的關係	次的關係/SH
차조사단	차/NNB + 조사단/NNG
차지원분	차/NNB + 지원/NNG + 분/XSN
대조고비	대조/NNG + 고비/NNG
대할머니	대/NNB + 할머니/NNG
데시빌쯤	데시빌/NNB + 쯤/XSN
개항지시	개/NNB + 항/NNG + 지시/NNG
리바운드	리바운드/NNG
리어카분	리어카/NNG + 분/XSN
도창의대	도/NNG + 창의대/NNG
독립선언	독립/NNG + 선언/NNG
돈쭝짜리	돈쭝/NNB + 짜리/XSN
단계사업	단계/NNG + 사업/NNG
네다섯쯤	네다섯/NR + 쯤/XSN
리터들이	리터/NNB + 들이/XSN
개년계획	개년/NNB + 계획/NNG
네버다이	네버다이/NNG
동사무소	동사무소/NNG
리터짜리	리터/NNB + 짜리/XSN
드라이버	드라이버/NNG
마더보드	마더보드/NNG
등기관사	등/NNB + 기관사/NNG
등서기관	등/NNB + 서기관/NNG
천가구씩	천/NR + 가구/NNG + 씩/XSN
천달러대	천/NR + 달러/NNB + 대/NNB
천만달러	천만/NR + 달러/NNB
천만엔대	천만/NR + 엔/NNB + 대/XSN
천만여명	천만/NR + 여/XSN + 명/NNB
천만여원	천만/NR + 여/XSN + 원/NNB
천만여주	천만/NR + 여/XSN + 주/NNG
천만원대	천만/NR + 원/NNB + 대/XSN
천만원씩	천만/NR + 원/NNB + 씩/XSN
천명미만	천/NR + 명/NNB + 미만/NNG
천명이상	천/NR + 명/NNB + 이상/NNG
천석거리	천/NR + 석/NNB + 거리/NNG
천수백만	천/NR + 수백만/NR
천억규모	천억/NR + 규모/NNG
천억달러	천억/NR + 달러/NNB
천억여원	천억/NR + 여/XSN + 원/NNB
천억원대	천억/NR + 원/NNB + 대/XSN
천억원등	천억/NR + 원/NNB + 등/NNB
단팔마왕	단팔/NNG + 마왕/NNG
천억조성	천억/NR + 조성/NNG
천여가지	천/NR + 여/XSN + 가지/NNB
천여그루	천/NR + 여/XSN + 그루/NNB
천여마리	천/NR + 여/XSN + 마리/NNB
천여만원	천/NR + 여/XSN + 만/NR + 원/NNB
천여명선	천/NR + 여/XSN + 명/NNB + 선/NNG
천여세대	천/NR + 여/XSN + 세대/NNG
천여억원	천/NR + 여/XSN + 억/NR + 원/NNB
천여표쯤	천/NR + 여/XSN + 표/NNG + 쯤/XSN
천여표차	천/NR + 여/XSN + 표차/NNG
천여필지	천/NR + 여/XSN + 필지/NNB
천원어치	천원어치/NNG
천원짜리	천/NR + 원/NNB + 짜리/XSN
천W짜리	천/NR + W/SL + 짜리/XSN
초생활권	초/NNB + 생활/NNG + 권/XSN
층베란다	층/NNG + 베란다/NNG
층탑신부	층/NNG + 탑신부/NNG
칠평짜리	칠/NR + 평/NNB + 짜리/XSN
크루제이	크루제이/NNG
키로미터	키로미터/NNG
킬로그램	킬로그램/NNB
킬로미터	킬로미터/NNB
킬로미터	킬로미터/NNG
킬로비트	킬로비트/NNG
킬로와트	킬로와트/NNB
탑식가람	탑식/NNG + 가람/NNG
텔레비전	텔레비전/NNG
텔리비전	텔리비전/NNG
파운드당	파운드/NNB + 당/XSN
팔십칠년	팔/NR + 십칠/NR + 년/NNB
퍼센트선	퍼센트/NNB + 선/NNG
퍼센트씩	퍼센트/NNB + 씩/XSN
퍼센트쯤	퍼센트/NNB + 쯤/NNG
퍼센트쯤	퍼센트/NNB + 쯤/XSN
페니짜리	페니/NNG + 짜리/XSN
페이지씩	페이지/NNG + 씩/XSN
평반짜리	평/NNB + 반/NNG + 짜리/XSN
평방미터	평방미터/NNB
평형짜리	평/NNB + 형/XSN + 짜리/XSN
포인트당	포인트/NNG + 당/XSN
프랑짜리	프랑/NNB + 짜리/XSN
마력짜리	마력/NNB + 짜리/XSN
프로야구	프로/NNG + 야구/NNG
프로축구	프로/NNG + 축구/NNG
피리어드	피리어드/NNG
피아스타	피아스타/NNG
피코그램	피코그램/NNG
하나은행	하나은행/NNP
학급이상	학급/NNG + 이상/NNG
학년때쯤	학년/NNG + 때/NNG + 쯤/XSN
학년이래	학년/NNG + 이래/NNB
학년이상	학년/NNG + 이상/NNG
학년짜리	학년/NNG + 짜리/XSN
학점이내	학점/NNG + 이내/NNG
학점짜리	학점/NNG + 짜리/XSN
할아버지	할아버지/NNG
합당합당	합당/NNG + 합당/NNG
호집자리	호/NNB + 집자리/NNG
회계연도	회계/NNG + 연도/NNG
CC짜리	CC/SL + 짜리/XSN
cc짜리	cc/SL + 짜리/XSN
city	city/SL
cm내외	cm/SL + 내외/NNG
cm정도	cm/SL + 정도/NNG
Cm정도	Cm/SL + 정도/NNG
cm조금	cm/SL + 조금/NNG
D캐릭터	D/SL + 캐릭터/NNG
KB짜리	KB/SL + 짜리/XSN
Kbps	Kbps/SL
kcal	kcal/SL
Kcal	Kcal/SL
kg정도	kg/SL + 정도/NNG
kg짜리	kg/SL + 짜리/XSN
km2당	km/SL + 2/SN + 당/XSN
km정도	km/SL + 정도/NNG
km지점	km/SL + 지점/NNG
km짜리	km/SL + 짜리/XSN
km행렬	km/SL + 행렬/NNG
m남짓씩	m/SL + 남짓/NNB + 씩/XSN
MBC배	MBC/SL + 배/NNG
Mbps	Mbps/SL
mesh	mesh/SL
mini	mini/SL
ml짜리	ml/SL + 짜리/XSN
mm영화	mm/SL + 영화/NNG
mm이상	mm/SL + 이상/NNG
mm필름	mm/SL + 필름/NNG
mmHg	mmHg/SL
t반짜리	t/SL + 반/NNG + 짜리/XSN
umol	umol/SL
년대쯤	년대/NNB + 쯤/XSN
백억엔	백억/NR + 엔/NNB
백억여	백억/NR + 여/XSN
백억원	백억/NR + 원/NNB
百억원	百/SH + 억/NR + 원/NNB
방송사	방송사/NNG
년대초	년대/NNB + 초/NNB
백억평	백억/NR + 평/NNB
백억t	백억/NR + t/SL
백엔당	백/NR + 엔/NNB + 당/XSN
백여개	백/NR + 여/XSN + 개/NNB
배가량	배/NNG + 가량/NNG
백여건	백/NR + 여/XSN + 건/NNB
백여곳	백/NR + 여/XSN + 곳/NNG
백여년	백/NR + 여/XSN + 년/NNB
백여대	백/NR + 여/XSN + 대/NNB
백여리	백/NR + 여/XSN + 리/NNB
백여만	백/NR + 여/XSN + 만/NR
배이상	배/NNG + 이상/NNG
배정도	배/NNG + 정도/NNG
백여명	백/NR + 여/XSN + 명/NNB
백여발	백/NR + 여/XSN + 발/NNB
백여부	백/NR + 여부/NNG
백여석	백/NR + 여/XSN + 석/NNB
백여실	백/NR + 여/XSN + 실/NNB
백여쌍	백/NR + 여/XSN + 쌍/NNG
백여억	백/NR + 여/XSN + 억/NR
백여장	백/NR + 여/XSN + 장/NNB
백여점	백/NR + 여/XSN + 점/NNB
백여종	백/NR + 여/XSN + 종/NNG
백여척	백/NR + 여/XSN + 척/NNB
백여통	백/NR + 여/XSN + 통/NNB
만대씩	만/NR + 대/NNB + 씩/XSN
백여팀	백/NR + 여/XSN + 팀/NNG
백여평	백/NR + 여/XSN + 평/NNB
백여표	백/NR + 여/XSN + 표/NNG
백여호	백/NR + 여/XSN + 호/NNB
백여회	백/NR + 여/XSN + 회/NNB
백여m	백/NR + 여/XSN + m/SL
년대판	년대/NNB + 판/NNB
백여t	백/NR + 여/XSN + t/SL
백원당	백/NR + 원/NNB + 당/XSN
백원선	백/NR + 원/NNB + 선/NNG
백원씩	백/NR + 원/NNB + 씩/XSN
백위권	백/NR + 위/NNB + 권/XSN
백일간	백/NR + 일/NNB + 간/NNG
백일분	백/NR + 일/NNB + 분/XSN
백장씩	백/NR + 장/NNB + 씩/XSN
백조원	백조/NR + 원/NNB
백주년	백/NR + 주년/NNB
백켤레	백/NR + 켤레/NNB
백톤급	백/NR + 톤/NNB + 급/NNG
백프랑	백/NR + 프랑/NNB
백海里	백/NR + 海里/SH
백화점	백화점/NNG
백회선	백/NR + 회선/NNG
백cc	백/NR + cc/SL
백g당	백/NR + g/SL + 당/XSN
백g대	백/NR + g/SL + 대/NNG
당1회	당/NNG + 1/SN + 회/NNB
백kg	백/NR + kg/SL
백km	백/NR + km/SL
백Km	백/NR + Km/SL
만마리	만/NR + 마리/NNB
년대풍	년대/NNB + 풍/XSN
백m당	백/NR + m/SL + 당/XSN
만마일	만/NR + 마일/NNB
백m쯤	백/NR + m/SL + 쯤/XSN
백mm	백/NNG + mm/SL
백MW	백/NR + MW/SL
마일쯤	마일/NNB + 쯤/NNG
백t씩	백/NR + t/SL + 씩/XSN
번국도	번/NNB + 국도/NNG
번시드	번/NNB + 시드/NNG
백11	백/NR + 11/SN
번우드	번/NNB + 우드/NNG
번이상	번/NNB + 이상/NNG
번째간	번/NNB + 째/XSN + 간/NNG
번째쯤	번/NNB + 째/XSN + 쯤/NNG
번째쯤	번/NNB + 째/XSN + 쯤/XSN
번타자	번/NNB + 타자/NNG
범이것	범/XPN + 이/NNP + 것/NNB
년도분	년도/NNB + 분/XSN
베이징	베이징/NNP
병들이	병/NNG + 들이/XSN
보1배	보/NNB + 1/SN + 배/NNG
보안대	보안대/NNG
보충대	보충/NNG + 대/NNG
보충대	보충대/NNG
복음서	복음서/NNG
부1속	부/NNG + 1/SN + 속/NNB
부경기	부/NNB + 경기/NNG
부능선	부능선/NNG
부단독	부/NNB + 단독/NNG
부리그	부/NNB + 리그/NNG
부부장	부부장/NNG
부속실	부속실/NNG
부요인	부/NNG + 요인/NNG
부장관	부/NNG + 장관/NNG
부종사	부/NNG + 종사/NNG
부짜리	부/NNB + 짜리/XSN
부총리	부총리/NNG
부투어	부/NNB + 투어/NNG
부합동	부/NNG + 합동/NNG
년도판	년도/NNB + 판/NNG
디나르	디나르/NNB
년동안	년/NNB + 동안/NNG
만명당	만/NR + 명/NNB + 당/XSN
만명선	만/NR + 명/NNB + 선/NNG
만명씩	만/NR + 명/NNB + 씩/XSN
가구당	가구/NNG + 당/XSN
만바트	만/NR + 바트/NNP
분가량	분/NNB + 가량/NNG
분간격	분/NNB + 간격/NNG
분간씩	분/NNB + 간/NNG + 씩/XSN
분거리	분/NNB + 거리/NNG
분기내	분기/NNG + 내/NNB
분기중	분기/NNG + 중/NNB
분기쯤	분기/NNG + 쯤/XSN
분뉴스	분/NNB + 뉴스/NNG
분동안	분/NNB + 동안/NNG
분발언	분/NNB + 발언/NNG
분법적	분법/NNG + 적/XSN
분사열	분/NNG + 사/NR + 열/NNG
분여간	분/NNB + 여/XSN + 간/NNG
분여만	분여/NNG + 만/NNB
분이내	분/NNB + 이내/NNG
분이상	분/NNB + 이상/NNG
분정도	분/NNB + 정도/NNG
분짜리	분/NNB + 짜리/XSN
분폭리	분/XSN + 폭리/NNG
공사업	공/NNG + 사업/NNG
불짜리	불/NNB + 짜리/XSN
블록슛	블록/NNG + 슛/NNG
비서관	비서관/NNG
공청산	공/NNG + 청산/NNG
만배럴	만/NR + 배럴/NNB
비트씩	비트/NNB + 씩/XSN
비트용	비트/NNB + 용/XSN
사나흘	사나흘/NNG
사단장	사단장/NNG
사사구	사사구/NNG
당대표	당/NNG + 대표/NNG
사이즈	사이즈/NNG
사이클	사이클/NNG
사체제	사/NNG + 체제/NNG
사흘째	사흘/NNG + 째/XSN
삭망월	삭망월/NNG
살박이	살/NNB + 박이/XSN
살배기	살/NNB + 배기/XSN
살소녀	살/NNB + 소녀/NNG
살이상	살/NNB + 이상/NNG
살짜리	살/NNB + 짜리/XSN
상자당	상자/NNG + 당/XSN
상회의	상/NNG + 회의/NNG
색과실	색/NNG + 과실/NNG
색과일	색/NNG + 과일/NNG
色선율	色/SH + 선율/NNG
만번째	만/NR + 번/NNB + 째/XSN
서방님	서방/NNG + 님/XSN
서비스	서비스/NNG
석가량	석/NNB + 가량/NNG
석지기	석/NNB + 지기/NNG
석짜리	석/NNB + 짜리/XSN
선개헌	선/NNG + 개헌/NNG
선거구	선거구/NNG
선고지	선/NNB + 고지/NNG
선생님	선생/NNG + 님/XSN
選手團	選手團/SH
선운동	선/NNG + 운동/NNG
선의원	선/NNB + 의원/NNG
선이상	선/NNG + 이상/NNG
선취임	선/NNG + 취임/NNG
성장군	성/NNG + 장군/NNG
세계적	세계/NNG + 적/XSN
세교육	세/NNB + 교육/NNG
세기간	세기/NNG + 간/NNB
세기간	세기간/NNG
세기경	세기/NNG + 경/XSN
세기께	세기/NNG + 께/XSN
세기만	세기/NNG + 만/NNB
세기말	세기말/NNG
世紀末	世紀末/SH
만봉투	만/NR + 봉투/NNG
세기사	세기/NNG + 사/NNG
세기식	세기/NNG + 식/NNB
세기적	세기/NNG + 적/XSN
세기전	세기/NNG + 전/NNG
세기쯤	세기/NNG + 쯤/XSN
세기초	세기/NNG + 초/NNB
세기파	세기/NNG + 파/NNG
세기형	세기/NNG + 형/XSN
世紀化	世紀化/SH
세대중	세대/NNG + 중/NNG
세들이	세/NNB + 들이/XSN
세리씩	세리/NNB + 씩/XSN
세미만	세/NNB + 미만/NNG
세이브	세이브/NNG
세이상	세/NNB + 이상/NNG
세짜리	세/NNB + 짜리/XSN
세출산	세/NNB + 출산/NNG
세포기	세포기/NNG
센트씩	센트/NNB + 씩/XSN
센티쯤	센티/NNB + 쯤/XSN
소경체	소경체/NNG
소대장	소대장/NNG
속정도	속/NNB + 정도/NNG
손가락	손가락/NNG
손자놈	손자/NNG + 놈/NNB
수년간	수년/NNG + 간/NNG
수년만	수년/NNG + 만/NNB
수만원	수만/NR + 원/NNB
수사대	수사대/NNG
수십년	수십/NR + 년/NNB
수차례	수차례/NNG
순노모	순/NNG + 노모/NNG
순노인	순/NNG + 노인/NNG
旬老母	旬老母/SH
순찰차	순찰차/NNG
숟가락	숟가락/NNG
만섬당	만/NR + 섬/NNB + 당/XSN
만세대	만/NR + 세대/NNG
黨代表	黨代表/SH
마일쯤	마일/NNB + 쯤/XSN
년만기	년/NNB + 만기/NNG
루땅볼	루/NNG + 땅볼/NNG
담당관	담당관/NNG
개부문	개/NNB + 부문/NNG
만여개	만/NR + 여/XSN + 개/NNB
마장쯤	마장/NNB + 쯤/XSN
게임씩	게임/NNG + 씩/XSN
라디오	라디오/NNG
만여건	만/NR + 여/XSN + 건/NNB
라운드	라운드/NNG
등주자	등/NNB + 주자/NNG
년말경	년/NNB + 말/NNB + 경/XSN
년말대	년/NNB + 말/NNB + 대/XSN
년맞이	년/NNB + 맞이/NNG
만여권	만/NR + 여/XSN + 권/NNB
만여년	만/NR + 여/XSN + 년/NNB
共淸算	共淸算/SH
만여대	만/NR + 여/XSN + 대/NNB
개대학	개/NNB + 대학/NNG
만여명	만/NR + 여/XSN + 명/NNB
년반만	년/NNB + 반/NNG + 만/NNB
만여석	만/NR + 여/XSN + 석/NNB
만여실	만/NR + 여/XSN + 실/NNG
공세력	공/NNG + 세력/NNG
만여원	만/NR + 여/XSN + 원/NNB
마지기	마지기/NNB
만여장	만/NR + 여/XSN + 장/NNB
만여점	만/NR + 여/XSN + 점/NNB
년사이	년/NNB + 사이/NNG
만여정	만/NR + 여/XSN + 정/NNB
강대결	강/NNG + 대결/NNG
만여종	만/NR + 여/XSN + 종/NNG
만여주	만/NR + 여/XSN + 주/NNG
만여컷	만/NR + 여/XSN + 컷/NNG
만여평	만/NR + 여/XSN + 평/NNB
개도시	개/NNB + 도시/NNG
개분야	개/NNB + 분야/NNG
년선배	년/NNB + 선배/NNG
년선생	년/NNB + 선생/NNG
계절색	계절/NNG + 색/NNG
만여t	만/NR + 여/XSN + t/SL
공초기	공/NNG + 초기/NNG
계절중	계절/NNG + 중/NNB
개사당	개/NNB + 사/NNG + 당/XSN
개사씩	개/NNB + 사/NNG + 씩/XSN
담배갑	담배/NNG + 갑/NNG
시간내	시간/NNB + 내/NNB
시간당	시간/NNB + 당/XSN
시간대	시간대/NNG
만원권	만/NR + 원/NNB + 권/NNG
시간뒤	시간/NNB + 뒤/NNG
시간만	시간/NNB + 만/NNB
시간만	시간/NNB + 만/NNB
만원권	만/NR + 원/NNB + 권/XSN
시간반	시간/NNB + 반/NNG
시간분	시간/NNB + 분/NNB
시간씩	시간/NNB + 씩/XSN
시간씩	시간/NNG + 씩/XSN
시간여	시간/NNB + 여/XSN
시간여	시간/NNG + 여/XSN
시간전	시간/NNB + 전/NNG
시간전	시간/NNB + 전/NNG
만원꼴	만/NR + 원/NNB + 꼴/XSN
만원대	만/NR + 원/NNB + 대/NNB
시간제	시간/NNG + 제/XSN
시간중	시간/NNB + 중/NNB
시간째	시간/NNG + 째/XSN
시간쯤	시간/NNB + 쯤/NNG
시경쯤	시/NNB + 경/XSN + 쯤/NNG
시그마	시그마/NNG
시뉴스	시/NNB + 뉴스/NNG
시리즈	시리즈/NNG
개사중	개/NNB + 사/NNG + 중/NNB
시반경	시/NNB + 반/NNG + 경/XSN
시반쯤	시/NNB + 반/NNG + 쯤/XSN
시이후	시/NNB + 이후/NNG
시즌간	시즌/NNG + 간/NNG
시출근	시/NNB + 출근/NNG
시현재	시/NNB + 현재/NNG
실링씩	실링/NNB + 씩/XSN
심무죄	심/NNG + 무/XPN + 죄/NNG
심법원	심/NNG + 법원/NNG
심재판	심/NNG + 재판/NNG
만원선	만/NR + 원/NNB + 선/NNG
십만명	십만/NR + 명/NNB
달체불	달/NNB + 체불/NNG
만원씩	만/NR + 원/NNB + 씩/XSN
쎈티씩	쎈티/NNB + 씩/XSN
달러씩	달러/NNB + 씩/XSN
당독재	당/NNG + 독재/NNG
아들네	아들/NNG + 네/XSN
아버지	아버지/NNG
아시안	아시안/NNG
만원외	만/NR + 원/NNB + 외/NNG
아울렛	아울렛/NNG
아테네	아테네/NNP
안렌즈	안/NNG + 렌즈/NNG
류광대	류/XSN + 광대/NNG
야드선	야드/NNG + 선/NNG
백2실	백/NR + 2/SN + 실/NNG
야드쯤	야드/NNB + 쯤/XSN
약사제	약사/NNG + 제/XSN
양동이	양동이/NNG
양주류	양주/NNG + 류/XSN
양화점	양화점/NNG
공화국	공화국/NNG
개星霜	개/NNB + 星霜/SH
共和國	共和國/SH
개소씩	개소/NNB + 씩/XSN
류국가	류/XSN + 국가/NNG
개市銀	개/NNB + 市銀/SH
량가구	량/NNB + 가구/NNG
각추형	각추/NNG + 형/XSN
과목씩	과목/NNG + 씩/XSN
개업체	개/NNB + 업체/NNG
관편성	관/NNG + 편성/NNG
광고팀	광고/NNG + 팀/NNG
각편대	각/NNG + 편대/NNG
개들이	개/NNB + 들이/XSN
만원쯤	만/NR + 원/NNB + 쯤/XSN
만위안	만/NR + 위안/NNB
강신화	강/NNG + 신화/NNG
강외교	강/NNG + 외교/NNG
게임째	게임/NNG + 째/XSN
만유로	만/NR + 유로/NNB
류수준	류/XSN + 수준/NNG
만이상	만/NR + 이상/NNG
대가수	대/XPN + 가수/NNG
류인생	류/XSN + 인생/NNG
량가구	량/NNG + 가구/NNG
구급대	구급대/NNG
대강령	대/NNB + 강령/NNG
구매장	구매장/NNG
개월간	개월/NNB + 간/NNB
계파간	계파/NNG + 간/NNB
개월간	개월/NNB + 간/NNG
대강령	대/NNG + 강령/NNG
개월경	개월/NNB + 경/XSN
각형석탑	각형/NNG + 석탑/NNG
대계열	대/NNG + 계열/NNG
대고질	대/NNG + 고질/NNG
개월내	개월/NNB + 내/NNB
개월당	개월/NNB + 당/XSN
대과제	대/NNG + 과제/NNG
개교당	개/NNB + 교/NNG + 당/XSN
대교장	대/NNB + 교장/NNG
대국회	대/NNB + 국회/NNG
개월래	개월/NNB + 래/NNB
개월만	개월/NNB + 만/NNB
개월분	개월/NNB + 분/XSN
개월씩	개월/NNB + 씩/XSN
代국회	代/SH + 국회/NNG
구조대	구조대/NNG
개월여	개월/NNB + 여/XSN
년여간	년/NNB + 여/XSN + 간/NNG
만장씩	만/NR + 장/NNB + 씩/XSN
대그룹	대/XPN + 그룹/NNG
대기업	대/XPN + 기업/NNG
대기업	대/XSN + 기업/NNG
년여만	년/NNB + 여/XSN + 만/NNB
개월용	개월/NNB + 용/XSN
개월전	개월/NNB + 전/NNG
년여전	년/NNB + 여/XSN + 전/NNG
대대장	대대장/NNG
대덕목	대/XSN + 덕목/NNG
개월째	개월/NNB + 째/XSN
개월쯤	개월/NNB + 쯤/NNG
가마니	가마니/NNG
개월쯤	개월/NNB + 쯤/XSN
국정부	국/NNG + 정부/NNG
대도시	대/XPN + 도시/NNG
간구조	간/NNB + 구조/NNG
개교씩	개/NNB + 교/NNG + 씩/XSN
년여째	년/NNB + 여/XSN + 째/XSN
년여쯤	년/NNB + 여/XSN + 쯤/NNG
만켤레	만/NR + 켤레/NNB
개월치	개월/NNB + 치/XSN
국회담	국/NNG + 회담/NNG
대명장	대/NNG + 명장/NNG
개이상	개/NNB + 이상/NNG
개작품	개/NNB + 작품/NNG
당야합	당/NNG + 야합/NNG
년연속	년/NNB + 연속/NNG
년연장	년/NNB + 연장/NNG
년요양	년/NNB + 요양/NNG
대목표	대/NNG + 목표/NNG
군단장	군단장/NNG
군데쯤	군데/NNB + 쯤/XSN
개재벌	개/NNB + 재벌/NNG
년이내	년/NNB + 이내/NNG
개정도	개/NNB + 정도/NNG
년이래	년/NNB + 이래/NNB
년이상	년/NNB + 이상/NNG
대문안	대문/NNG + 안/NNG
억개비	억/NR + 개비/NNG
억달러	억/NR + 달러/NNB
年이상	年/SH + 이상/NNG
년이후	년/NNB + 이후/NNG
억바트	억/NR + 바트/NNP
억불꼴	억/NR + 불/NNB + 꼴/XSN
억불씩	억/NR + 불/NNB + 씩/XSN
억불탑	억/NR + 불/NNB + 탑/NNG
억비트	억/NR + 비트/NNB
대문화	대/NNB + 문화/NNG
억어치	억/NR + 어치/NNG
억여명	억/NR + 여/XSN + 명/NNB
억여원	억/NR + 여/XSN + 원/NNB
달러선	달러/NNB + 선/NNG
억원당	억/NR + 원/NNB + 당/XSN
억원대	억/NR + 원/NNB + 대/XSN
억원선	억/NR + 원/NNB + 선/NNG
억원씩	억/NR + 원/NNB + 씩/XSN
억원중	억/NR + 원/NNB + 중/NNB
共비리	共/SH + 비리/NNG
억원쯤	억/NR + 원/NNB + 쯤/XSN
억위안	억/NR + 위안/NNB
억짜리	억/NR + 짜리/XSN
억통화	억/NR + 통화/NNG
억투자	억/NR + 투자/NNG
년전쟁	년/NNB + 전쟁/NNG
언고시	언/NNG + 고시/NNG
언더파	언더/NNG + 파/NNG
언배율	언/NNG + 배율/NNG
언율시	언/NNG + 율시/NNG
언절구	언/NNG + 절구/NNG
에이커	에이커/NNB
엔짜리	엔/NNB + 짜리/XSN
여가구	여/XSN + 가구/NNG
여가지	여/XSN + 가지/NNB
여개국	여/XSN + 개국/NNB
共非理	共非理/SH
여개뿐	여/XSN + 개/NNB + 뿐/NNB
여개사	여/XSN + 개/NNB + 사/NNG
여개소	여/XSN + 개소/NNB
여개월	여/XSN + 개월/NNB
여개인	여/XSN + 개인/NNG
여개층	여/XSN + 개/NNB + 층/NNG
여건씩	여/XSN + 건/NNB + 씩/XSN
여곳씩	여/XSN + 곳/NNG + 씩/XSN
여군데	여/XSN + 군데/NNB
여권중	여/XSN + 권/NNB + 중/NNB
여그루	여/XSN + 그루/NNB
여년간	여/XSN + 년/NNB + 간/NNG
여년만	여/XSN + 년/NNB + 만/NNB
여년씩	여/XSN + 년/NNB + 씩/XSN
여년전	여/XSN + 년/NNB + 전/NNG
여년째	여/XSN + 년/NNB + 째/XSN
여년후	여/XSN + 년/NNB + 후/NNG
여대쯤	여/XSN + 대/NNB + 쯤/XSN
여동생	여동생/NNG
만피트	만/NR + 피트/NNB
년전쯤	년/NNB + 전/NNG + 쯤/XSN
여마리	여/XSN + 마리/NNB
여마일	여/XSN + 마일/NNG
여만개	여/XSN + 만/NR + 개/NNB
공시기	공/NNG + 시기/NNG
여만대	여/XSN + 만/NR + 대/NNB
여만명	여/XSN + 만/NR + 명/NNB
여만부	여/XSN + 만/NR + 부/NNB
여만원	여/XSN + 만/NR + 원/NNB
만헤알	만/NR + 헤알/NNG
여만자	여/XSN + 만/NR + 자/NNG
여만장	여/XSN + 만/NR + 장/NNB
여만주	여/XSN + 만/NR + 주/NNG
여만평	여/XSN + 만/NR + 평/NNB
강의실	강의실/NNG
여명선	여/XSN + 명/NNB + 선/NNG
여명씩	여/XSN + 명/NNB + 씩/XSN
년정도	년/NNB + 정도/NNG
여명중	여/XSN + 명/NNB + 중/NNB
여분간	여/XSN + 분/NNB + 간/NNG
게임차	게임/NNG + 차/NNG
여분만	여/XSN + 분/NNB + 만/NNB
여분씩	여/XSN + 분/NNB + 씩/XSN
여분쯤	여/XSN + 분/NNB + 쯤/XSN
여시간	여/XSN + 시간/NNG
여억개	여/XSN + 억/NR + 개/NNB
여억원	여/XSN + 억/NR + 원/NNB
여업체	여/XSN + 업체/NNG
여일간	여/XSN + 일/NNB + 간/NNG
여일만	여/XSN + 일/NNB + 만/NNB
여점씩	여/XSN + 점/NNB + 씩/XSN
여차례	여/XSN + 차례/NNG
여초간	여/XSN + 초/NNB + 간/NNG
공시대	공/NNG + 시대/NNG
여톤씩	여/XSN + 톤/NNB + 씩/XSN
여통씩	여/XSN + 통/NNG + 씩/XSN
여km	여/XSN + km/SL
여Km	여/XSN + Km/SL
여m씩	여/XSN + m/SL + 씩/XSN
달러쯤	달러/NNB + 쯤/XSN
여m쯤	여/XSN + m/SL + 쯤/XSN
여t씩	여/XSN + t/SL + 씩/XSN
연대장	연대장/NNG
연락방	연락/NNG + 방/NNG
만ha	만/NR + ha/SL
연승자	연승자/NNG
연승째	연승/NNG + 째/XSN
연타석	연타석/NNG
엿새날	엿새/NNG + 날/NNG
예닐곱	예닐곱/NR
만kg	만/NR + kg/SL
만km	만/NR + km/SL
오라비	오라비/NNG
만kW	만/NR + kW/SL
오버파	오버/NNG + 파/NNG
오빠네	오빠/NNG + 네/XSN
올림픽	올림픽/NNG
외국어	외국어/NNG
운영계	운영/NNG + 계/XSN
원가량	원/NNB + 가량/NNG
원벌이	원/NNB + 벌이/NNG
원어찌	원/NNB + 어찌/NNB
원어치	원/NNB + 어치/NNG
원전략	원/NNG + 전략/NNG
원정도	원/NNB + 정도/NNG
원지폐	원/NNB + 지폐/NNG
원짜리	원/NNB + 짜리/XSN
元체제	元/SH + 체제/NNG
만t급	만/NR + t/SL + 급/NNG
만t씩	만/NR + t/SL + 씩/XSN
대봉사	대/NNB + 봉사/NNG
년가량	년/NNB + 가량/NNG
년지기	년/NNB + 지기/NNG
년짜리	년/NNB + 짜리/XSN
년간씩	년/NNB + 간/NNG + 씩/XSN
매짜리	매/NNB + 짜리/XSN
개구단	개/NNB + 구단/NNG
개구역	개/NNB + 구역/NNG
년개정	년/NNB + 개정/NNG
년고도	년/NNB + 고도/NNG
년고찰	년/NNB + 고찰/NNG
년공부	년/NNB + 공부/NNG
며느리	며느리/NNG
월결산	월/NNB + 결산/NNG
륜구동	륜/NNG + 구동/NNG
월공세	월/NNB + 공세/NNG
월관련	월/NNB + 관련/NNG
월구일	월/NNB + 구/NR + 일/NNB
월단체	월/NNB + 단체/NNG
월대선	월/NNB + 대선/NNG
월드컵	월드컵/NNG
월말경	월/NNB + 말/NNB + 경/XSN
월말경	월말/NNG + 경/XSN
월말께	월말/NNG + 께/XSN
월말쯤	월말/NNG + 쯤/XSN
월법인	월/NNB + 법인/NNG
월봉기	월/NNB + 봉기/NNG
월사이	월/NNB + 사이/NNG
월사태	월/NNB + 사태/NNG
월운동	월/NNB + 운동/NNG
월유신	월/NNB + 유신/NNG
月維新	月維新/SH
륜마차	륜/NNG + 마차/NNG
년공주	년/NNB + 공주/NNG
월이래	월/NNB + 이래/NNB
월이후	월/NNB + 이후/NNG
년과정	년/NNB + 과정/NNG
월중순	월/NNB + 중순/NNG
월초께	월/NNB + 초/NNB + 께/XSN
월초쯤	월/NNB + 초/NNB + 쯤/XSN
월총선	월/NNB + 총선/NNG
월투쟁	월/NNB + 투쟁/NNG
월하순	월/NNB + 하순/NNG
월항쟁	월/NNB + 항쟁/NNG
월혁명	월/NNB + 혁명/NNG
월현재	월/NNB + 현재/NNG
월협상	월/NNB + 협상/NNG
위권내	위/NNB + 권/XSN + 내/NNG
위끼리	위/NNB + 끼리/XSN
위수상	위/NNB + 수상/NNG
위안씩	위안/NNB + 씩/XSN
위원회	위원회/NNG
위입상	위/NNB + 입상/NNG
위자리	위/NNB + 자리/NNG
위종목	위/NNB + 종목/NNG
위차지	위/NNB + 차지/NNG
육십오	육십오/NR
음보격	음보/NNG + 격/NNB
음음악	음/NNG + 음악/NNG
音音樂	音音樂/SH
가구분	가구/NNG + 분/XSN
이년도	이/NR + 년도/NNB
이모님	이모/NNG + 님/XSN
이백만	이백/NR + 만/NR
경기당	경기/NNG + 당/XSN
이십년	이십/NR + 년/NNB
공시절	공/NNG + 시절/NNG
이튿날	이튿날/NNG
경기씩	경기/NNG + 씩/XSN
인1실	인/NNG + 1/SN + 실/NNG
인1조	인/NNG + 1/SN + 조/NNG
인2역	인/NNG + 2/SN + 역/NNG
인가구	인/NNG + 가구/NNG
인가족	인/NNG + 가족/NNG
인그룹	인/NNG + 그룹/NNG
당체제	당/NNG + 체제/NNG
인사색	인/NNG + 사색/NNG
인소위	인/NNG + 소위/NNG
인승무	인/NNB + 승무/NNG
인시위	인/NNG + 시위/NNG
인위원	인/NNG + 위원/NNG
인이상	인/NNG + 이상/NNG
경기째	경기/NNG + 째/XSN
인지배	인/NNG + 지배/NNG
인치대	인치/NNB + 대/XSN
인치형	인치/NNB + 형/XSN
면짜리	면/NNG + 짜리/XSN
인특위	인/NNG + 특위/NNG
당총무	당/NNG + 총무/NNG
년기준	년/NNB + 기준/NNG
일간씩	일/NNB + 간/NNG + 씩/XSN
일경기	일/NNB + 경기/NNG
일계획	일/NNB + 계획/NNG
일기도	일/NNB + 기도/NNG
일동안	일/NNB + 동안/NNG
일무공	일/NNB + 무공/NNP
일미국	일/NNB + 미국/NNP
일불공	일/NNB + 불공/NNG
일사이	일/NR + 사이/NNG
일새벽	일/NNB + 새벽/NNG
일신행	일/NNB + 신행/NNG
일오전	일/NNB + 오전/NNG
일오후	일/NNB + 오후/NNG
일유가	일/NNB + 유가/NNG
일이내	일/NNB + 이내/NNG
일입주	일/NNB + 입주/NNG
일작전	일/NNB + 작전/NNG
일전쟁	일/NNB + 전쟁/NNG
일전쯤	일/NNB + 전/NNG + 쯤/XSN
일전후	일/NNB + 전후/NNG
일정도	일/NNB + 정도/NNG
일짜리	일/NNB + 짜리/XSN
일째쯤	일/NNB + 째/XSN + 쯤/XSN
명구속	명/NNB + 구속/NNG
角關係	角關係/SH
자개입	자/NNB + 개입/NNG
명구조	명/NNB + 구조/NNG
자관계	자/NNB + 관계/NNG
자대결	자/NNG + 대결/NNG
자리수	자리/NNG + 수/NNG
자연대	자연대/NNG
자인수	자/NNG + 인수/NNG
자제분	자제/NNG + 분/NNB
자주의	자/NNB + 주의/NNG
자주의	자/NNG + 주의/NNG
자짜리	자/NNB + 짜리/XSN
자책점	자책점/NNG
자토론	자/NNG + 토론/NNG
자회담	자/NNB + 회담/NNG
자회동	자/NNG + 회동/NNG
작품당	작품/NNG + 당/XSN
명내외	명/NNB + 내외/NNG
장관실	장관실/NNG
장수사	장/NNG + 수사/NNG
장짜리	장/NNB + 짜리/XSN
년초쯤	년/NNB + 초/NNB + 쯤/XSN
전대회	전대회/NNG
전시관	전시관/NNG
전시실	전시실/NNG
전전승	전/NNG + 전승/NNG
전짜리	전/NNB + 짜리/XSN
전짜리	전/NNG + 짜리/XSN
점대별	점/NNB + 대/XSN + 별/XSN
점라인	점/NNB + 라인/NNG
점슛왕	점/NNB + 슛/NNG + 왕/NNG
점이상	점/NNB + 이상/NNG
점일기	점/NNG + 일기/NNG
점짜리	점/NNB + 짜리/XSN
점홈런	점/NNB + 홈런/NNG
정비창	정비창/NNG
고지선	고지/NNG + 선/NNG
대비극	대/NNG + 비극/NNG
대선거	대/NNB + 선거/NNG
권분립	권/XSN + 분립/NNG
대소녀	대/NNB + 소녀/NNG
권짜리	권/NNB + 짜리/XSN
명부상	명/NNB + 부상/NNG
그램쯤	그램/NNB + 쯤/NNG
代소년	代/SH + 소년/NNG
조1항	조/NNB + 1/SN + 항/NNG
경기차	경기/NNG + 차/NNG
그루씩	그루/NNB + 씩/XSN
그릇씩	그릇/NNG + 씩/XSN
극체제	극/NNG + 체제/NNG
極體制	極體制/SH
개종목	개/NNB + 종목/NNG
근짜리	근/NNB + 짜리/XSN
글로벌	글로벌/NNG
명사망	명/NNB + 사망/NNG
年基準	年基準/SH
대어족	대/XSN + 어족/NNG
개국간	개국/NNB + 간/NNB
가지중	가지/NNB + 중/NNB
대여자	대/NNB + 여자/NNG
금융권	금융/NNG + 권/XSN
명수배	명/NNB + 수배/NNG
간짜리	간/NNG + 짜리/XSN
급시험	급/NNG + 시험/NNG
급이상	급/NNG + 이상/NNG
명실종	명/NNB + 실종/NNG
대영장	대/NNB + 영장/NNG
개지구	개/NNB + 지구/NNG
개地區	개/NNB + 地區/SH
대원칙	대원칙/NNG
기계화	기계/NNG + 화/XSN
명안팎	명/NNB + 안팎/NNG
대의원	대의원/NNG
개지대	개/NNB + 지대/NNG
기교육	기/NNG + 교육/NNG
기동대	기동대/NNG
개지역	개/NNB + 지역/NNG
代議員	代議員/SH
개질병	개/NNB + 질병/NNG
개짜리	개/NNB + 짜리/XSN
기의장	기/NNG + 의장/NNG
기체제	기/NNG + 체제/NNG
명이상	명/NNB + 이상/NNG
개찰구	개찰구/NNG
순위자	순위자/NNG
대의혹	대/NNG + 의혹/NNG
대二代	대/NNB + 二代/SH
김시대	김/NNP + 시대/NNG
대이상	대/NNB + 이상/NNG
대장손	대/NNB + 장손/NNG
개체씩	개체/NNG + 씩/XSN
대재벌	대/XPN + 재벌/NNG
김정치	김/NNP + 정치/NNG
김청산	김/NNP + 청산/NNG
김체제	김/NNP + 체제/NNG
대제자	대/NNB + 제자/NNG
꼬챙이	꼬챙이/NNG
꿈나무	꿈/NNG + 나무/NNG
조달러	조/NR + 달러/NNB
조어치	조/NR + 어치/NNG
조원대	조/NR + 원/NNB + 대/XSN
조원선	조/NR + 원/NNB + 선/NNG
조원씩	조/NR + 원/NNB + 씩/XSN
명정도	명/NNB + 정도/NNG
조정관	조정관/NNG
곡병풍	곡/NNG + 병풍/NNG
조투입	조/NR + 투입/NNG
족협화	족/NNG + 협화/NNG
종경기	종/NNG + 경기/NNG
종면허	종/NNG + 면허/NNG
종정도	종/NNG + 정도/NNG
종진단	종/NNG + 진단/NNG
종채권	종/NNG + 채권/NNG
년농사	년/NNB + 농사/NNG
주가량	주/NNB + 가량/NNG
만가구	만/NR + 가구/NNG
주년쯤	주년/NNB + 쯤/XSN
주동안	주/NNB + 동안/NNG
주비전	주비전/NNG
주야여	주야/NNG + 여/XSN
주연속	주/NNB + 연속/NNG
주일간	주일/NNB + 간/NNG
주일경	주일/NNB + 경/XSN
주일만	주일/NNB + 만/NNB
주일새	주일/NNB + 새/NNG
주일씩	주일/NNB + 씩/XSN
주일여	주일/NNB + 여/XSN
주일전	주일/NNB + 전/NNG
주일째	주일/NNB + 째/XSN
주일쯤	주일/NNB + 쯤/XSN
주일후	주일/NNB + 후/NNG
주택자	주택자/NNG
주훈련	주/NNB + 훈련/NNG
중거주	중/NNG + 거주/NNG
중구조	중/NNG + 구조/NNG
중국적	중국적/NNG
중기단	중/NNG + 기단/NNG
중대장	중대장/NNG
중밑창	중/NNG + 밑창/NNG
중전회	중전회/NNG
中全會	中全會/SH
중주단	중주단/NNG
중청구	중/NNG + 청구/NNG
중학교	중학교/NNG
중화산	중/NNG + 화산/NNG
진장치	진/NNG + 장치/NNG
집단씩	집단/NNG + 씩/XSN
집반승	집/NNG + 반/NNG + 승/NNG
집음반	집/NNB + 음반/NNG
짝창호	짝/NNG + 창호/NNG
쪽짜리	쪽/NNG + 짜리/XSN
차계획	차/NNB + 계획/NNG
차고객	차/NNB + 고객/NNG
차공사	차/NNB + 공사/NNG
차공천	차/NNB + 공천/NNG
차공판	차/NNB + 공판/NNG
차관보	차관보/NNG
차교섭	차/NNB + 교섭/NNG
차기소	차/NNB + 기소/NNG
차년도	차/NNB + 년도/NNB
차대전	차/NNB + 대전/NNG
차대회	차/NNB + 대회/NNG
차례씩	차례/NNG + 씩/XSN
차리그	차/NNB + 리그/NNG
차명단	차/NNB + 명단/NNG
차모임	차/NNB + 모임/NNG
차물량	차/NNB + 물량/NNG
차방어	차/NNB + 방어/NNG
명확정	명/NNB + 확정/NNG
차범행	차/NNB + 범행/NNG
차병원	차/NNB + 병원/NNG
차부도	차/NNB + 부도/NNG
차산업	차/NNB + 산업/NNG
차산품	차/NNB + 산품/NNG
차상품	차/NNB + 상품/NNG
차선씩	차선/NNG + 씩/XSN
차성징	차/NNB + 성징/NNG
뇌신경	뇌신경/NNG
차수사	차/NNB + 수사/NNG
차시험	차/NNB + 시험/NNG
차신경	차/NNB + 신경/NNG
차업체	차/NNB + 업체/NNG
차예심	차/NNB + 예심/NNG
차원적	차원/NNG + 적/XSN
차자료	차/NNB + 자료/NNG
차장보	차장보/NNG
차장직	차장/NNG + 직/NNG
차조사	차/NNB + 조사/NNG
당통합	당/NNG + 통합/NNG
强정책	强/SH + 정책/NNG
次集團	次集團/SH
차침공	차/NNB + 침공/NNG
차투표	차/NNB + 투표/NNG
차협상	차/NNB + 협상/NNG
차협의	차/NNB + 협의/NNG
차회담	차/NNB + 회담/NNG
차회의	차/NNB + 회의/NNG
차후보	차/NNB + 후보/NNG
척장신	척/NNB + 장신/NNG
리가량	리/NNB + 가량/NNG
대조모	대/NNB + 조모/NNG
대조묘	대조/NNG + 묘/NNG
나노m	나노/NNG + m/SL
대존속	대/NNB + 존속/NNG
대종단	대/NNG + 종단/NNG
대주부	대/NNB + 주부/NNG
대주주	대주주/NNG
대진미	대/XPN + 진미/NNG
대진사	대/NNB + 진사/NNG
대착복	대/XSN + 착복/NNG
나절씩	나절/NNB + 씩/XSN
대천왕	대/XPN + 천왕/NNG
개품목	개/NNB + 품목/NNG
곡짜리	곡/NNG + 짜리/XSN
당합당	당/NNG + 합당/NNG
공연탄	공연탄/NNG
다래끼	다래끼/NNG
강진출	강/NNG + 진출/NNG
개국뿐	개국/NNB + 뿐/NNB
대총선	대/NNB + 총선/NNG
나한전	나한전/NNG
개국어	개/NNB + 국어/NNG
대취학	대/NNG + 취학자/NNG +
나흘날	나흘/NNG + 날/NNG
대학자	대/NNB + 학자/NNG
나흘째	나흘/NNG + 째/XSN
대회장	대/NNB + 회장/NNG
댓살쯤	댓/NR + 살/NNB + 쯤/XSN
개국중	개국/NNB + 중/NNB
데시벨	데시벨/NNB
날개깃	날개깃/NNG
强體制	强體制/SH
공열차	공/NNG + 열차/NNG
강축하	강/NNG + 축하/NNG
무1패	무/NNG + 1/SN + 패/NNG
강탈락	강/NNG + 탈락/NNG
리짜리	리/NNB + 짜리/XSN
남1녀	남/NNG + 1/SN + 녀/NNG
남2녀	남/NNG + 2/SN + 녀/NNG
도백하	도/NNG + 백하/NNP
男2女	男/SH + 2/SN + 女/SH
도三道	도/NNG + 三道/SH
도선상	도/NNB + 선상/NNG
남3녀	남/NNG + 3/SN + 녀/NNG
남4녀	남/NNG + 4/SN + 녀/NNG
남5녀	남/NNG + 5/SN + 녀/NNG
도의군	도의군/NNG
골프장	골프장/NNG
남대로	남/NNG + 대로/NNG
도짜리	도/NNB + 짜리/XSN
無축구	無/SH + 축구/NNG
도호부	도호부/NNG
내무실	내무실/NNG
경비단	경비단/NNG
돈짜리	돈/NNB + 짜리/XSN
문포획	문/NNB + 포획/NNG
경비정	경비정/NNG
공장장	공장장/NNG
단계설	단계설/NNG
문학사	문학/NNG + 사/NNG
년대경	년대/NNB + 경/XSN
냥짜리	냥/NNB + 짜리/XSN
단계씩	단계/NNG + 씩/XSN
돌공연	돌/NNB + 공연/NNG
단구성	단/NNB + 구성/NNG
돌기념	돌/NNB + 기념/NNG
돌행사	돌/NNB + 행사/NNG
네마리	네/XSN + 마리/NNB
단논법	단/NNG + 논법/NNG
문항씩	문항/NNG + 씩/XSN
문화층	문화/NNG + 층/XSN
공정권	공/NNG + 정권/NNG
개기업	개/NNB + 기업/NNG
년대관	년/NNB + 대관/NNG
개년간	개년/NNB + 간/NNG
단보당	단보/NNB + 당/XSN
가마분	가마/NNG + 분/NNG
미터대	미터/NNB + 대/NNG
미터씩	미터/NNB + 씩/XSN
만개소	만/NR + 개소/NNB
미터쯤	미터/NNB + 쯤/XSN
두서넛	두서넛/NR
共권력	共/SH + 권력/NNG
가지말	가지/NNB + 말/NNB
공단절	공/NNG + 단절/NNG
개호기	개/NNB + 호/NNB + 기/NNB
마일간	마일/NNB + 간/NNB
공당시	공/NNG + 당시/NNG
단위당	단위/NNG + 당/XSN
등공신	등/NNB + 공신/NNG
가마당	가마/NNG + 당/XSN
단지내	단지/NNG + 내/NNB
바라밀	바라밀/NNG
등급제	등급/NNG + 제/XSN
단짜리	단/NNB + 짜리/XSN
거래일	거래일/NNG
가구꼴	가구/NNG + 꼴/XSN
바이알	바이알/NNG
등분할	등/NNB + 분할/NNG
천가구	천/NR + 가구/NNG
천개소	천/NR + 개소/NNB
천그루	천/NR + 그루/NNB
천년간	천년간/NNG
천년경	천/NR + 년/NNB + 경/XSN
천년대	천/NR + 년/NNB + 대/XSN
천년전	천/NR + 년/NNB + 전/NNG
千年前	千年前/SH
천달러	천/NR + 달러/NNB
단체장	단체장/NNG
천돈쭝	천/NR + 돈쭝/NNB
천루블	천/NR + 루블/NNG
천리엘	천/NR + 리엘/NNB
단층화	단/NNB + 층/NNG + 화/XSN
천마일	천/NR + 마일/NNB
천만개	천만/NR + 개/NNB
천만년	천만/NR + 년/NNB
천만단	천만/NR + 단/NNG
천만대	천만대/NNG
천만동	천만/NR + 동/NNB
천만명	천만/NR + 명/NNB
천만부	천만/NR + 부/NNB
천만분	천만/NR + 분/NNG
천만불	천만/NR + 불/NNB
천만엔	천만/NR + 엔/NNB
만그루	만/NR + 그루/NNB
천만여	천만/NR + 여/XSN
년대말	년대/NNB + 말/NNB
등선실	등/NNB + 선실/NNG
마이크	마이크/NNG
천만원	천만/NR + 원/NNB
막짜리	막/NNB + 짜리/XSN
백91	백/NR + 91/SN
천만인	천만/NR + 인/NNG
천만t	천만/NR + t/SL
천명선	천/NR + 명/NNB + 선/NNG
천명씩	천/NR + 명/NNB + 씩/XSN
년대생	년대/NNB + 생/XSN
천명쯤	천/NR + 명/NNB + 쯤/NNG
천미터	천/NR + 미터/NNB
천박스	천/NR + 박스/NNG
천세대	천/NR + 세대/NNG
천송이	천/NR + 송이/NNG
박2일	박/NNB + 2/SN + 일/NNB
천시간	천/NR + 시간/NNG
가구씩	가구/NNG + 씩/XSN
천억대	천억/NR + 대/XSN
천억만	천/NR + 억만/NR
천억설	천억/NR + 설/NNG
천억여	천억/NR + 여/XSN
만년전	만/NR + 년/NNB + 전/NNG
천억원	천억/NR + 원/NNB
박3일	박/NNB + 3/SN + 일/NNB
년대선	년/NNB + 대선/NNG
달여간	달/NNB + 여/XSN + 간/NNG
천엔씩	천/NR + 엔/NNB + 씩/XSN
각구조	각/NNG + 구조/NNG
천여개	천/NR + 여/XSN + 개/NNB
천여건	천/NR + 여/XSN + 건/NNB
천여곳	천/NR + 여/XSN + 곳/NNG
천여권	천/NR + 여/XSN + 권/NNB
년대식	년대/NNB + 식/NNB
천여년	천/NR + 여/XSN + 년/NNB
천여대	천/NR + 여/XSN + 대/NNB
박4일	박/NNB + 4/SN + 일/NNB
천여만	천/NR + 여/XSN + 만/NR
천여명	천/NR + 여/XSN + 명/NNB
만달러	만/NR + 달러/NNB
천여병	천/NR + 여/XSN + 병/NNG
천여억	천/NR + 여/XSN + 억/NR
박5일	박/NNB + 5/SN + 일/NNB
천여원	천/NR + 여/XSN + 원/NNB
천여장	천/NR + 여/XSN + 장/NNB
천여점	천/NR + 여/XSN + 점/NNB
천여종	천/NR + 여/XSN + 종/NNG
천여주	천/NR + 여/XSN + 주/NNG
천여채	천/NR + 여/XSN + 채/NNB
천여척	천/NR + 여/XSN + 척/NNB
천여통	천/NR + 여/XSN + 통/NNB
천여평	천/NR + 여/XSN + 평/NNB
마일당	마일/NNB + 당/XSN
공정부	공/NNG + 정부/NNG
천여t	천/NR + 여/XSN + t/SL
천원권	천원권/NNG
천원꼴	천/NR + 원/NNB + 꼴/XSN
천원대	천/NR + 원/NNB + 대/XSN
천원선	천/NR + 원/NNB + 선/NNG
천원씩	천/NR + 원/NNB + 씩/XSN
천위안	천/NR + 위안/NNB
천촉광	천/NR + 촉광/NNG
천축국	천축국/NNG
천킬로	천/NR + 킬로/NNB
천피트	천/NR + 피트/NNB
천Bq	천/NR + Bq/SL
천cc	천/NR + cc/SL
천kg	천/NR + kg/SL
천km	천/NR + km/SL
千km	千/SH + km/SL
천t급	천/NR + t/SL + 급/NNG
박6일	박/NNB + 6/SN + 일/NNB
첩반상	첩/NNB + 반상/NNG
체육관	체육관/NNG
야전군	야전군/NNG
기병대	기병대/NNG
중대내	중대/NNG + 내/NNB
체제안	체제/NNG + 안/NNG
초동안	초/NNB + 동안/NNG
마일씩	마일/NNG + 씩/XSN
초짜리	초/NNB + 짜리/XSN
촉짜리	촉/NNB + 짜리/XSN
촌당숙	촌/NNG + 당숙/NNG
촌이내	촌/NNB + 이내/NNG
층공간	층/NNG + 공간/NNG
층구조	층/NNG + 구조/NNG
층기단	층/NNG + 기단/NNG
층당사	층/NNG + 당사/NNG
층만층	층/NNG + 만/NR + 층/NNG
층모델	층/NNG + 모델/NNG
층목탑	층/NNG + 목탑/NNG
층바닥	층/NNG + 바닥/NNG
층바닥	층/XSN + 바닥/NNG
층서재	층/NNG + 서재/NNG
층석탑	층/NNG + 석탑/NNG
층장롱	층/NNG + 장롱/NNG
층전탑	층/NNG + 전탑/NNG
층짜리	층/NNG + 짜리/XSN
층탑신	층/NNG + 탑신/NNG
칙연산	칙/NNG + 연산/NNG
백가구	백/NR + 가구/NNG
칸짜리	칸/NNG + 짜리/XSN
캐러츠	캐러츠/NNG
캐럿대	캐럿/NNG + 대/XSN
커트씩	커트/NNG + 씩/XSN
개회사	개/NNB + 회사/NNG
컴퓨터	컴퓨터/NNG
컷짜리	컷/NNG + 짜리/XSN
켤레씩	켤레/NNB + 씩/XSN
쿠데타	쿠데타/NNG
백가지	백/NR + 가지/NNB
백개씩	백/NR + 개/NNB + 씩/XSN
등성쯤	등/NNB + 성/NNG + 쯤/NNG
공비리	공/NNG + 비리/NNG
마디씩	마디/NNG + 씩/XSN
개년치	개년/NNB + 치/XSN
킬로씩	킬로/NNB + 씩/XSN
킬로쯤	킬로/NNB + 쯤/XSN
타석째	타석/NNG + 째/XSN
타수째	타수/NNG + 째/XSN
탈삼진	탈삼진/NNG
백권씩	백/NR + 권/NNB + 씩/XSN
태양년	태양년/NNG
태음월	태음월/NNG
백그루	백/NR + 그루/NNG
톤짜리	톤/NNB + 짜리/XSN
통협정	통/NNG + 협정/NNG
통화당	통화/NNG + 당/XSN
투표구	투표구/NNG
투표권	투표/NNG + 권/XSN
투표소	투표소/NNG
특별부	특별/NNG + 부/NNG
파운드	파운드/NNB
개단지	개/NNB + 단지/NNG
파출소	파출소/NNG
팔백원	팔백/NR + 원/NNB
팔참회	팔/NR + 참회/NNG
퍼센트	퍼센트/NNB
퍼센트	퍼센트/NNG
백년간	백/NR + 년/NNB + 간/NNG
박8일	박/NNB + 8/SN + 일/NNB
백년사	백년사/NNG
百年前	百年前/SH
페이지	페이지/NNG
백년쯤	백/NR + 년/NNB + 쯤/XSN
개대대	개/NNB + 대대/NNG
평가량	평/NNB + 가량/NNG
백달러	백/NR + 달러/NNB
달러당	달러/NNB + 당/XSN
평방m	평방/NNG + m/SL
평이상	평/NNB + 이상/NNG
평짜리	평/NNB + 짜리/XSN
평크기	평/NNB + 크기/NNG
평형대	평/NNB + 형/XSN + 대/XSN
평형B	평/NNB + 형/XSN + B/SL
평형C	평/NNB + 형/XSN + C/SL
포기당	포기/NNG + 당/XSN
포인트	포인트/NNG
폭병풍	폭/NNG + 병풍/NNG
폭짜리	폭/NNG + 짜리/XSN
품종명	품종명/NNG
프랑씩	프랑/NNB + 씩/XSN
프레임	프레임/NNG
박9일	박/NNB + 9/SN + 일/NNB
백대당	백/NR + 대/NNB + 당/XSN
피고인	피고인/NNG
백마리	백/NR + 마리/NNB
박계통	박/NNG + 계통/NNG
학급씩	학급/NNG + 씩/XSN
백마일	백/NR + 마일/NNB
학기때	학기/NNG + 때/NNG
학기말	학기/NNG + 말/NNB
학기제	학기/NNG + 제/XSN
학기중	학기/NNG + 중/NNB
학기째	학기/NNG + 째/XSN
학기초	학기/NNG + 초/NNB
학년도	학년/NNG + 도/NNB
학년때	학년/NNG + 때/NNG
학년말	학년/NNG + 말/NNB
학년생	학년/NNG + 생/XSN
학년용	학년/NNG + 용/XSN
박사일	박/NNB + 사/NR + 일/NNB
백만개	백만/NR + 개/NNB
학년제	학년/NNG + 제/XSN
학년짜	학년/NNG + 짜리/XSN +
박삼일	박/NNB + 삼/NR + 일/NNB
학년쯤	학년/NNG + 쯤/XSN
학년초	학년/NNG + 초/NNB
학점분	학점/NNG + 분/XSN
백만건	백만/NR + 건/NNB
백만년	백만/NR + 년/NNB
한강교	한강교/NNG
등자리	등/NNB + 자리/NNG
백만단	백만/NR + 단/NNG
가지약	가지/NNB + 약/NNG
할가량	할/NNB + 가량/NNG
할정도	할/NNB + 정도/NNG
박오일	박/NNB + 오/NR + 일/NNB
백만대	백만/NR + 대/NNB
백만매	백만/NR + 매/NNB
항공대	항공대/NNP
항술어	항/NNG + 술어/NNG
항아리	항아리/NNG
행정관	행정관/NNG
행정리	행정리/NNG
헤르츠	헤르츠/NNB
마르크	마르크/NNG
협력관	협력관/NNG
형님댁	형/NNG + 님/XSN + 댁/NNG
형사부	형사부/NNG
백만명	백만/NR + 명/NNB
호궁전	호/NNB + 궁전/NNG
호문지	호/NNB + 문지/NNG
호법정	호/NNB + 법정/NNG
호선역	호/NNB + 선/NNG + 역/NNG
호선중	호/NNB + 선/NNG + 중/NNB
호열차	호/NNB + 열차/NNG
호위성	호/NNB + 위성/NNG
호정문	호/NNB + 정문/NNG
백만분	백만/NR + 분/NNG
호집터	호/NNB + 집터/NNG
호짜리	호/NNB + 짜리/XSN
홀짜리	홀/NNG + 짜리/XSN
홉들이	홉/NNB + 들이/XSN
환짜리	환/NNB + 짜리/XSN
회가량	회/NNB + 가량/NNG
백만불	백만/NR + 불/NNB
회대회	회/NNB + 대회/NNG
백만石	백만/NR + 石/SH
회연장	회/NNB + 연장/NNG
회용품	회/NNB + 용품/NNG
회우승	회/NNB + 우승/NNG
훈련소	훈련소/NNG
층석탑	층/NNG + 석탑/NNG
B정책	B/SL + 정책/NNG
마리뿐	마리/NNB + 뿐/NNB
bps	bps/SL
C중반	C/SL + 중반/NNG
cc급	cc/SL + 급/NNG
cc당	cc/SL + 당/XSN
白萬石	白萬石/SH
百萬石	百萬石/SH
cc차	c/SL + c/SL + 차/NNG
cfu	cfu/SL
백만섬	백만/NR + 섬/NNB
백만엔	백만/NR + 엔/NNB
cm당	cm/SL + 당/XSN
cm씩	cm/SL + 씩/XSN
백만여	백만/NR + 여/XSN
박이일	박/NNB + 이/NR + 일/NNB
cm쯤	cm/SL + 쯤/XSN
cup	cup/SL
D부문	D/SL + 부문/NNG
D산업	D/SL + 산업/NNG
D업종	D/SL + 업종/NNG
마리씩	마리/NNB + 씩/XSN
D영화	D/SL + 영화/NNG
D직종	D/SL + 직종/NNG
백만원	백만/NR + 원/NNB
DX급	DX/SL + 급/NNG
g짜리	g/SL + 짜리/XSN
H클럽	H/SL + 클럽/NNG
ha중	ha/SL + 중/NNB
K이상	K/SL + 이상/NNG
반세기	반세기/NNG
초짜리	초/NNB + 짜리/XSN
년대적	년대/NNB + 적/XSN
Kev	Kev/SL
kg급	kg/SL + 급/NNG
kG급	kG/SL + 급/NNG
kg씩	kg/SL + 씩/XSN
경주당	경주/NNG + 당/XSN
kg쯤	kg/SL + 쯤/XSN
KGy	KGy/SL
KHz	KHz/SL
KHZ	KHZ/SL
kHz	kHz/SL
KHz	KHz/SL
km2	km/SL + 2/SN
만대군	만/NR + 대군/NNG
km내	km/SL + 내/NNB
km당	km/SL + 당/XSN
km대	km/SL + 대/XSN
km씩	km/SL + 씩/XSN
백만인	백만/NR + 인/NNG
백만장	백만/NR + 장/NNB
백만질	백만/NR + 질/NNB
km쯤	km/SL + 쯤/XSN
l짜리	l/SL + 짜리/XSN
백만톤	백만/NR + 톤/NNB
백만평	백만/NR + 평/NNB
백만호	백만/NR + 호/NNB
m가량	m/SL + 가량/NNG
m길이	m/SL + 길이/NNG
백만t	백만/NR + t/SL
m높이	m/SL + 높이/NNG
m범위	m/SL + 범위/NNG
m아래	m/SL + 아래/NNG
m어간	m/SL + 어간/NNG
m정도	m/SL + 정도/NNG
M정도	M/SL + 정도/NNG
M제품	M/SL + 제품/NNG
m지점	m/SL + 지점/NNG
m짜리	m/SL + 짜리/XSN
mg씩	mg/SL + 씩/XSN
MHz	MHz/SL
Mhz	Mhz/SL
발가락	발가락/NNG
백명분	백/NR + 명/NNB + 분/XSN
백명씩	백/NR + 명/NNB + 씩/XSN
mm포	mm/SL + 포/NNG
백명중	백/NR + 명/NNB + 중/NNB
one	one/SL
ppb	ppb/SL
ppm	ppm/SL
PPM	PPM/SL
R14	R/SL + 14/SN
rad	rad/SL
백명쯤	백/NR + 명/NNB + 쯤/XSN
백미터	백/NR + 미터/NNB
t짜리	t/SL + 짜리/XSN
t트럭	t/SL + 트럭/NNG
마리아	마리아/NNP
v짜리	v/SL + 짜리/XSN
W투어	W/SL + 투어/NNG
달러대	달러/NNB + 대/XSN
만4	만/NR + 4/SN
달쯤	달/NNB + 쯤/XSN
매쉬	매쉬/NNG
매씩	매/NNB + 씩/XSN
루측	루/NNG + 측/NNB
분간	분/NNB + 간/NNB
년쯤	년/NNB + 쯤/XSN
분간	분/NNB + 간/NNG
계급	계급/NNG
년차	년/NNB + 차/NNB
매체	매체/NNG
백g	백/NR + g/SL
란성	란/NNG + 성/XSN
맥박	맥박/NNG
개국	개국/NNB
계단	계단/NNG
머쉰	머쉰/NNG
個國	個國/SH
계명	계명/NNG
먹이	먹이/NNG
메가	메가/NNB
방향	방향/NNG
달만	달/NNB + 만/NNB
분경	분/NNB + 경/XSN
건씩	건/NNB + 씩/XSN
거리	거리/NNB
년명	년/NNB + 명/NNB
分頃	分頃/SH
마흔	마흔/NR
닷새	닷새/NNG
年銘	年銘/SH
분과	분과/NNG
마일	마일/NNG
분기	분기/NNG
메끼	메끼/NNG
년초	년/NNB + 초/NNB
년물	년/NNB + 물/NNG
년경	년/NNB + 경/XSN
당제	당/NNG + 제/XSN
루타	루/NNG + 타/NNG
년반	년/NNB + 반/NNG
백億	백/NR + 億/SH
개도	개/NNB + 도/NNG
계약	계약/NNG
경기	경기/NNG
분께	분/NNB + 께/XSN
분내	분/NNB + 내/NNB
년법	년/NNB + 법/NNG
년복	년/NNB + 복/NNG
분단	분단/NNG
월경	월/NNB + 경/XSN
분당	분/NNB + 당/XSN
백m	백/NNG + m/SL
분뒤	분/NNB + 뒤/NNG
월기	월/NNB + 기/NNG
월께	월/NNB + 께/XSN
년봄	년/NNB + 봄/NNG
월달	월/NNB + 달/NNG
년분	년/NNB + 분/XSN
월드	월드/NNG
계장	계장/NNG
월란	월/NNB + 란/NNG
월령	월령/NNG
월말	월/NNB + 말/NNB
분류	분류/NNG
분만	분/NNB + 만/NNB
년뿐	년/NNB + 뿐/NNB
분박	분/NNG + 박/NNG
월물	월/NNB + 물/NNB
대분	대/NNB + 분/XSN
루피	루피/NNB
월분	월/NNB + 분/XSN
분발	분/NNB + 발/NNG
년사	년사/NNG
월생	월/NNB + 생/XSN
월씩	월/NNB + 씩/XSN
백m	백/NR + m/SL
분법	분/XSN + 법/NNG
방리	방리/NNG
백발	백/NR + 발/NNB
번대	번/NNB + 대/NNG
분씩	분/NNB + 씩/XSN
년산	년/NNB + 산/XSN
년상	년/NNB + 상/NNG
월장	월/NNB + 장/NNG
년初	년/NNB + 初/SH
월제	월/NNB + 제/XSN
월조	월/NNB + 조/NNB
月조	月/SH + 조/NNG
월중	월/NNB + 중/NNB
月中	月中/SH
룩스	룩스/NNB
월쯤	월/NNB + 쯤/NNG
월쯤	월/NNB + 쯤/XSN
월초	월/NNB + 초/NNB
月初	月初/SH
분야	분야/NNG
분여	분/NNB + 여/XSN
강때	강/NNG + 때/NNG
월치	월/NNB + 치/XSN
월토	월토/NNG
년새	년/NNB + 새/NNG
백번	백/NR + 번/NNB
계절	계절/NNG
개과	개과/NNG
공수	공수/NNG
월호	월/NNB + 호/NNB
위국	위/NNB + 국/NNG
위권	위/NNB + 권/XSN
백벌	백/NR + 벌/NNB
년도	년도/NNB
위묘	위/NNB + 묘/NNG
위산	위산/NNP
시간	시간/NNB
위안	위/NNB + 안/NNG
위안	위안/NNB
시간	시간/NNG
위임	위임/NNG
분자	분자/NNG
개비	개비/NNG
위전	위/NNB + 전/NNG
분전	분/NNB + 전/NNG
배속	배속/NNG
위팀	위/NNB + 팀/NNG
위표	위/NNB + 표/NNG
유로	유로/NNB
음계	음계/NNG
음보	음보/NNG
공초	공/NNG + 초/NNB
개뿐	개/NNB + 뿐/NNB
음절	음절/NNG
개사	개/NNB + 사/NNG
당척	당척/NNG
의사	의사/NNG
분지	분지/NNG
이닝	이닝/NNG
이동	이동/NNG
이모	이모/NNG
만동	만/NR + 동/NNB
이백	이백/NNG
이상	이상/NNG
분쯤	분/NNB + 쯤/XSN
이틀	이틀/NNG
년식	년/NNB + 식/NNB
면내	면/NNG + 내/NNB
이후	이후/NNG
륜차	륜/NNG + 차/NNG
년급	년/NNB + 급/NNG
개관	개/NNB + 관/NNG
분파	분파/NNG
年度	年度/SH
분할	분할/NNG
분화	분화/NNG
개社	개/NNB + 社/SH
방면	방면/NNG
인간	인간/NNG
인극	인/NNG + 극/NNG
인당	인/NNG + 당/XSN
人當	人當/SH
계좌	계좌/NNG
개교	개/NNB + 교/NNG
인무	인/NNG + 무/NNG
면대	면/NNG + 대/NNB
인방	인/NNG + 방/NNG
인분	인/NNG + 분/XSN
만원	만/NR + 원/NNB
인승	인/NNG + 승/NNG
백t	백/NR + t/SL
인실	인/NNG + 실/NNG
인씩	인/NNG + 씩/XSN
인역	인/NNG + 역/NNG
인용	인/NNG + 용/XSN
人委	人委/SH
불씩	불/NNB + 씩/XSN
면모	면모/NNG
군현	군현/NNG
백부	백/NR + 부/NNB
불통	불통/NNG
인자	인자/NNG
인전	인전/NNG
인조	인/NNG + 조/NNG
블록	블록/NNG
면씩	면/NNG + 씩/XSN
인치	인치/NNB
백V	백/NR + V/SL
년기	년/NNB + 기/NNG
밸브	밸브/NNG
인칭	인칭/NNG
면체	면/NNG + 체/NNG
비트	비트/NNB
번가	번/NNB + 가/NNG
만등	만/NR + 등/NNB
일간	일/NNB + 간/NNB
당간	당/NNG + 간/NNB
일경	일/NNB + 경/XSN
번기	번/NNB + 기/NNG
면체	면체/NNG
강행	강/NNG + 행/NNG
일께	일/NNB + 께/XSN
일날	일/NNB + 날/NNG
일내	일/NNB + 내/NNB
일당	일/NNB + 당/XSN
일대	일대/NNG
빌딩	빌딩/NNG
일란	일/NNB + 란/NNG
일만	일/NNB + 만/NNB
一萬	一萬/SH
등칸	등/NNB + 칸/NNG
일물	일/NNB + 물/NNG
뿌리	뿌리/NNG
일밤	일/NNB + 밤/NNG
일부	일부/NNG
일분	일/NNB + 분/XSN
일분	일분/NNG
일상	일/NNB + 상/NNG
일생	일/NNB + 생/XSN
일시	일/NNB + 시/NNG
일씩	일/NNB + 씩/XSN
량가	량/NNB + 가/XSN
일용	일/NNB + 용/XSN
일월	일/NR + 월/NNB
시경	시/NNB + 경/XSN
일자	일/NNB + 자/NNG
일자	일자/NNG
일字	일/NNB + 字/SH
마을	마을/NNG
번꼴	번/NNB + 꼴/XSN
일장	일/NNB + 장/NNG
일전	일/NNB + 전/NNG
번뇌	번뇌/NNG
시기	시기/NNG
시께	시/NNB + 께/XSN
일제	일/NNB + 제/XSN
일중	일/NNB + 중/NNB
사간	사/NNG + 간/NNB
일째	일/NNB + 째/XSN
시대	시대/NNG
일쯤	일/NNB + 쯤/NNB
일쯤	일/NNB + 쯤/XSN
시루	시루/NNG
일치	일/NNB + 치/NNB
일후	일/NNB + 후/NNG
사건	사건/NNG
입중	입중/NNG
자간	자/NNG + 간/NNB
사구	사구/NNG
시반	시/NNB + 반/NNG
번대	번/NNB + 대/NNG
자녀	자녀/NNG
사단	사단/NNG
자루	자루/NNB
자리	자리/NNG
번대	번/NNB + 대/XSN
자매	자매/NNG
자모	자모/NNG
자식	자식/NNG
자씩	자/NNB + 씩/XSN
자씩	자/NNG + 씩/XSN
시장	시장/NNG
고지	고지/NNG
시점	시점/NNG
자제	자제/NNG
시즌	시즌/NNG
간방	간/NNB + 방/NNG
사도	사도/NNG
시쯤	시/NNB + 쯤/NNB
시쯤	시/NNB + 쯤/NNG
시쯤	시/NNB + 쯤/XSN
시차	시차/NNG
자평	자/NNG + 평/NNG
자평	자평/NNG
자형	자형/NNG
사람	사람/NNG
시티	시티/NNG
작품	작품/NNG
시합	시합/NNG
잔쯤	잔/NNG + 쯤/XSN
명꼴	명/NNB + 꼴/XSN
사례	사례/NNG
장관	장관/NNG
장군	장군/NNG
장당	장/NNB + 당/XSN
장대	장대/NNG
장면	장면/NNG
장문	장문/NNG
장벽	장벽/NNG
장복	장복/NNG
장사	장사/NNG
장소	장소/NNG
장씩	장/NNB + 씩/XSN
장씩	장/NNG + 씩/XSN
장여	장/NNB + 여/XSN
장자	장자/NNG
사무	사무/NNG
장형	장/NNB + 형/XSN
적제	적/NNG + 제/XSN
식구	식구/NNG
년치	년/NNB + 치/XSN
전대	전대/NNG
사발	사발/NNG
신고	신고/NNG
전씩	전/NNB + 씩/XSN
전쟁	전쟁/NNG
신당	신/XPN + 당/NNG
신분	신분/NNG
전후	전후/NNG
절기	절기/NNG
절지	절/NNG + 지/NNG
절터	절터/NNG
절후	절후/NNG
점대	점/NNB + 대/XSN
점때	점/NNB + 대/XSN
신사	신사/NNG
명당	명/NNB + 당/XSN
점슛	점/NNB + 슛/NNG
점씩	점/NNB + 씩/XSN
실링	실링/NNB
사분	사/NR + 분/NNB
실장	실장/NNG
점차	점/NNB + 차/NNG
점포	점/NNB + 포/NNG
점포	점포/NNG
실점	실점/NNG
접시	접시/NNG
접철	접철/NNG
정간	정간/NNG
정도	정도/NNG
정맥	정맥/NNG
정보	정보/NNB
공식	공식/NNG
정부	정부/NNG
량가	량/NNG + 가/NNG
정신	정신/NNG
정제	정/NNG + 제/XSN
정책	정책/NNG
굴덴	굴덴/NNG
번선	번/NNB + 선/NNG
사업	사업/NNG
고희	고희/NNG
대선	대선/NNG
명등	명/NNB + 등/NNB
제국	제국/NNG
제도	제도/NNG
제불	제불/NNG
제자	제자/NNG
굽이	굽이/NNG
궁전	궁전/NNG
백분	백/NR + 분/XSN
권값	권/NNB + 값/NNG
권당	권/NNB + 당/XSN
심제	심/NNG + 제/XSN
권씩	권/NNB + 씩/XSN
권역	권역/NNG
권중	권/NNB + 중/NNB
권째	권/NNB + 째/XSN
권쯤	권/NNB + 쯤/XSN
귀절	귀절/NNG
그램	그램/NNB
그램	그램/NNG
사위	사위/NNG
간씩	간/NNB + 씩/XSN
간씩	간/NNG + 씩/XSN
간지	간지/NNG
명분	명/NNB + 분/XSN
년판	년/NNB + 판/NNG
십년	십/NR + 년/NNB
십만	십만/NR
번씩	번/NNB + 씩/XSN
대손	대/NNB + 손/NNG
그루	그루/NNB
십명	십/NR + 명/NNB
그룹	그룹/NNG
그릇	그릇/NNG
가족	가족/NNG
십억	십억/NR
대손	대손/NNG
명뿐	명/NNB + 뿐/NNB
극간	극간/NNG
십여	십/NR + 여/XSN
십일	십/NR + 일/NR
대씩	대/NNB + 씩/XSN
쌍꼴	쌍/NNG + 꼴/NNG
개주	개/NNB + 주/NNG
대양	대양/NNG
쌍중	쌍/NNG + 중/NNB
쎈트	쎈트/NNB
배수	배수/NNG
大洋	大洋/SH
쎈티	쎈티/NNB
글자	글자/NNG
개중	개/NNB + 중/NNB
간집	간/NNB + 집/NNG
개반	개/NNB + 반/NNG
명선	명/NNB + 선/NNG
사찰	사찰/NNG
대여	대여/NNG
갤런	갤런/NNB
거두	거두/NNG
공역	공/NNG + 역/NNG
년형	년/NNB + 형/XSN
명소	명소/NNG
금융	금융/NNG
개지	개지/NNG
사천	사천/NR
급수	급수/NNG
공사	공사/NNG
아들	아들/NNG
사태	사태/NNG
간통	간통/NNB
사회	사회/NNG
만번	만/NR + 번/NNB
년씩	년/NNB + 씩/XSN
대왕	대/NNB + 왕/NNG
사후	사후/NNG
명씩	명/NNB + 씩/XSN
아우	아우/NNG
간폭	간/NNB + 폭/NNG
년께	년/NNB + 께/XSN
사흘	사흘/NNG
대원	대원/NNG
급지	급지/NNG
기가	기가/NNB
년후	년/NNB + 후/NNG
기갑	기갑/NNG
아이	아이/NNG
명안	명안/NNG
배씩	배/NNG + 씩/XSN
기관	기관/NNG
공시	공/NNG + 시/NNB
기당	기/NNB + 당/XSN
악곡	악곡/NNG
기록	기록/NNG
악장	악장/NNG
갈래	갈래/NNG
감각	감각/NNG
번중	번/NNB + 중/NNB
안타	안타/NNG
기분	기/NNG + 분/XSN
암제	암/NNG + 제/XSN
개째	개/NNB + 째/XSN
기사	기사/NNG
기생	기/NNB + 생/XSN
기씩	기/NNB + 씩/XSN
기암	기/NNB + 암/NNG
개쯤	개/NNB + 쯤/XSN
산화	산/NNG + 화/XSN
기자	기자/NNG
기준	기준/NNG
기층	기/NNB + 층/NNG
노구	노구/NNG
야당	야당/NNG
야드	야드/NNB
기통	기통/NNG
살경	살/NNB + 경/XSN
살때	살/NNB + 때/NNG
노령	노령/NNG
번지	번지/NNG
金식	金/SH + 식/NNB
개체	개체/NNG
김씨	김/NNP + 씨/NNB
金씨	金/SH + 씨/NNB
살반	살/NNB + 반/NNG
양주	양주/NNG
번째	번/NNB + 째/XSN
양푼	양푼/NNG
살선	살/NNB + 선/NNG
명절	명절/NNG
꼭지	꼭지/NNB
백원	백/NR + 원/NNB
노인	노인/NNG
조각	조각/NNG
조개	조/NR + 개/NNB
조건	조건/NNG
조명	조/NR + 명/NNB
조목	조목/NNG
조분	조/NR + 분/NNG
조상	조/NNB + 상/XSN
조씩	조/NR + 씩/XSN
조엔	조/NR + 엔/NNB
조여	조/NR + 여/XSN
조원	조/NR + 원/NNB
兆원	兆/SH + 원/NNB
딸네	딸/NNG + 네/XSN
개석	개/NNB + 석/NNG
공탄	공탄/NNG
년내	년/NNB + 내/NNB
조정	조정/NNG
개성	개/NNB + 성/NNG
百원	百/SH + 원/NNB
살짜	살/NNB + 짜리/XSN +
조평	조/NR + 평/NNB
개소	개소/NNB
존불	존불/NNG
종류	종류/NNG
종목	종목/NNG
종뿐	종/NNG + 뿐/NNB
종씩	종/NNG + 씩/XSN
종이	종이/NNG
종족	종족/NNG
개시	개/NNB + 시/NNG
종쯤	종/NNG + 쯤/XSN
개발	개발/NNG
종합	종합/NNG
살쯤	살/NNB + 쯤/XSN
각도	각/NNG + 도/NNG
주간	주/NNB + 간/NNB
주기	주기/NNB
대조	대/NNB + 조/NNG
주년	주년/NNB
周年	周年/SH
노조	노조/NNG
년대	년/NNB + 대/XSN
주당	주/NNG + 당/XSN
주만	주/NNB + 만/NNB
과목	과목/NNG
주씩	주/NNB + 씩/XSN
주씩	주/NNG + 씩/XSN
주야	주야/NNG
개씩	개/NNB + 씩/XSN
삼일	삼/NR + 일/NNG
주일	주일/NNB
삼진	삼진/NNG
삼촌	삼촌/NNG
삼회	삼/NR + 회/NNB
명중	명/NNB + 중/NNB
가사	가사/NNG
상씩	상/NNG + 씩/XSN
상자	상자/NNG
개동	개/NNB + 동/NNG
주전	주/NNB + 전/NNG
주째	주/NNB + 째/XSN
주쯤	주/NNB + 쯤/XSN
주차	주/NNB + 차/NNB
주택	주택/NNG
계층	계층/NNG
줄기	줄기/NNG
중고	중/NNG + 고/NNG
과장	과장/NNG
번쯤	번/NNB + 쯤/XSN
개안	개/NNB + 안/NNG
중대	중대/NNG
과제	과제/NNG
중적	중/NNG + 적/XSN
관당	관/NNB + 당/XSN
중주	중주/NNG
관문	관문/NNG
중창	중/NNG + 창/NNG
개어	개/NNB + 어/NNG
노총	노총/NNG
백불	백/NR + 불/NNG
관왕	관왕/NNG
지구	지구/NNG
지망	지망/NNG
명째	명/NNB + 째/XSN
지수	지수/NNG
지역	지역/NNG
지점	지점/NNG
진동	진동/NNG
진법	진법/NNG
진수	진/NNG + 수/NNG
집꼴	집/NNG + 꼴/NNG
집단	집단/NNG
집당	집/NNG + 당/XSN
집반	집/NNG + 반/NNG
개역	개/NNB + 역/NNG
집째	집/NNB + 째/XSN
짝씩	짝/NNB + 씩/XSN
광년	광년/NNB
째권	째/XSN + 권/NNB
째딸	째/XSN + 딸/NNG
째수	째/XSN + 수/NNB
새끼	새끼/NNG
각형	각/NNG + 형/XSN
번호	번/NNB + 호/NNG
노트	노트/NNG
각형	각형/NNG
차관	차관/NNG
번호	번호/NNG
색기	색기/NNG
번홀	번/NNB + 홀/NNG
색춤	색/NNG + 춤/NNG
명쯤	명/NNB + 쯤/XSN
차량	차량/NNG
차례	차례/NNG
류극	류/XSN + 극/NNG
차로	차로/NNG
생명	생명/NNG
버전	버전/NNG
서넛	서넛/NR
교대	교대/NNG
차분	차/NNB + 분/XSN
교시	교시/NNB
개월	개월/NNB
개붤	개월/NNB
차선	차선/NNG
교실	교실/NNG
교회	교회/NNG
차시	차/NNB + 시/NNB
서방	서방/NNG
강전	강전/NNG
뇌실	뇌실/NNG
벌씩	벌/NNB + 씩/XSN
서울	서울/NNP
차원	차원/NNG
次元	次元/SH
대가	대가/NNG
누나	누나/NNG
강행	강행/NNG
차장	차장/NNG
차적	차/NNB + 적/XSN
次的	次的/SH
차전	차/NNB + 전/NNG
벌타	벌/NNG + 타/NNG
대간	대간/NNG
누님	누님/NNG
량식	량/NNB + 식/NNB
구간	구간/NNG
석꾼	석/NNB + 꾼/XSN
구경	구경/NNG
참씩	참/NNG + 씩/XSN
창녀	창녀/NNG
창당	창당/NNG
채널	채널/NNG
처리	처리/NNG
처장	처장/NNG
처제	처/NNG + 제/XSN
누이	누이/NNG
석대	석/NNB + 대/NNB
뉴스	뉴스/NNG
척당	척/NNB + 당/XSN
척도	척도/NNG
척씩	척/NNB + 씩/XSN
척쯤	척/NNB + 쯤/XSN
대강	대/NNB + 강/NNG
모꼴	모/NNG + 꼴/XSN
모델	모델/NNG
모음	모음/NNG
배줌	배/NNG + 줌/NNG
모작	모작/NNG
만갑	만/NR + 갑/NNG
경비	경비/NNG
년안	년/NNB + 안/NNG
구년	구/NR + 년/NNB
범주	범주/NNG
강좌	강좌/NNG
나라	나라/NNG
개층	개/NNB + 층/NNG
대종	대/NNB + 종/NNG
개통	개/NNB + 통/NNG
석쯤	석/NNB + 쯤/XSN
대주	대주/NNG
갑씩	갑/NNG + 씩/XSN
대지	대/NNB + 지/NNG
만자	만/NR + 자/NNB
나무	나무/NNG
대째	대/NNB + 째/XSN
대쪽	대/NNB + 쪽/NNB
개팀	개/NNB + 팀/NNG
대쯤	대/NNB + 쯤/XSN
나이	나이/NNG
범행	범행/NNG
대개	대개/NNG
년여	년/NNB + 여/XSN
만병	만병/NNG
법칙	법칙/NNG
대초	대/NNB + 초/NNB
선급	선/NNB + 급/NNG
목적	목적/NNG
당수	당수/NNG
만매	만/NR + 매/NNB
나한	나한/NNG
고개	고개/NNG
선수	선수/NNG
대국	대/NNB + 국/NNG
배쯤	배/NNG + 쯤/XSN
나흘	나흘/NNG
가동	가동/NNG
개피	개피/NNG
리간	리/NNB + 간/NNB
대층	대/NNB + 층/XSN
대학	대학/NNG
목제	목/NNG + 제/XSN
대회	대회/NNG
가량	가량/NNG
리길	리/NNB + 길/NNG
개항	개/NNB + 항/NNG
구분	구분/NNG
덩이	덩이/NNG
다섯	다섯/NR
구비	구비/NNG
선지	선지/NNG
병당	병/NNG + 당/XSN
가례	가례/NNG
개군	개/NNB + 군/NNB
묘제	묘/NNG + 제/XSN
만개	만/NR + 개/NNB
공영	공영/NNG
구씩	구/NNB + 씩/XSN
도간	도/NNG + 간/NNB
구씩	구/NNG + 씩/XSN
도령	도령/NNG
도로	도로/NNG
리씩	리/NNB + 씩/XSN
공장	공장/NNG
年代	年代/SH
구역	구역/NNG
구절	구절/NNG
대군	대군/NNG
리장	리/NNB + 장/NNG
대궁	대/XPN + 궁/NNG
백인	백/NR + 인/NNG
건당	건/NNB + 당/XSN
병상	병상/NNG
도루	도루/NNG
만장	만/NR + 장/NNB
병씩	병/NNG + 씩/XSN
성적	성적/NNG
구째	구/NNG + 째/XSN
만정	만/NR + 정/NNB
도선	도/NNB + 선/NNG
성조	성조/NNG
도스	도스/NNG
성지	성지/NNG
도시	도시/NNG
도심	도심/NNG
도씩	도/NNB + 씩/XSN
골씩	골/NNG + 씩/XSN
골차	골/NNG + 차/NNG
도움	도움/NNG
당시	당시/NNG
도제	도/NNG + 제/XSN
대꼴	대/NNB + 꼴/XSN
남매	남매/NNG
남중	남/NNG + 중/NNB
낫싱	낫싱/NNG
만종	만/NR + 종/NNG
구체	구/NNG + 체/NNG
도쯤	도/NNB + 쯤/XSN
곳당	곳/NNG + 당/XSN
대당	대/NNB + 당/XSN
개현	개/NNB + 현/NNG
개군	개/NNB + 군/NNG
강팀	강팀/NNG
곳뿐	곳/NNG + 뿐/NNB
개부	개/NNB + 부/NNG
개권	개/NNB + 권/XSN
문씩	문/NNB + 씩/XSN
문자	문자/NNG
도쿄	도쿄/NNP
가지	가지/NNB
대대	대대/NNG
냥빚	냥/NNB + 빚/NNG
만주	만/NR + 주/NNG
돈쭝	돈쭝/NNB
문제	문제/NNG
단간	단/NNG + 간/NNB
냥씩	냥/NNB + 씩/XSN
국가	국가/NNG
단계	단계/NNG
국간	국/NNG + 간/NNB
國間	國間/SH
곳중	곳/NNG + 중/NNB
가마	가마/NNG
국당	국/NNG + 당/XSN
국민	국민/NNG
병원	병원/NNG
병쯤	병/NNG + 쯤/XSN
만쪽	만/NR + 쪽/NNG
네댓	네댓/NR
개급	개/NNB + 급/NNG
세계	세계/NNG
단독	단독/NNG
문항	문항/NNG
레인	레인/NNG
국사	국사/NNG
단보	단보/NNB
리쯤	리/NNB + 쯤/XSN
리터	리터/NNB
단보	단보/NNG
가방	가방/NNG
세기	세기/NNG
개꼴	개/NNB + 꼴/XSN
개년	개년/NNB
국산	국산/NNG
뭉치	뭉치/NNG
뮌헨	뮌헨/NNP
個年	個年/SH
국장	국장/NNG
世紀	世紀/SH
국제	국제/NNG
백일	백/NR + 일/NNB
미리	미리/NNB
공공	공/NR + 공/NR
미만	미만/NNG
공구	공구/NNG
대등	대/NNB + 등/NNB
보루	보루/NNB
대때	대/NNB + 때/NNG
동강	동강/NNG
동네	동네/NNG
동리	동리/NNG
미음	미음/NNG
개면	개/NNB + 면/NNG
대로	대로/NNG
미터	미터/NNB
미터	미터/NNG
롯데	롯데/NNP
보림	보림/NNG
립중	립/NNB + 중/NNG
고령	고령/NNG
보시	보/NNB + 시/NNG
대륙	대륙/NNG
민영	민영/NNG
대말	대/NNB + 말/NNB
동산	동/NNG + 산/NNG
민족	민족/NNG
동생	동생/NNG
동서	동서/NNG
갑자	갑자/NNG
배출	배출/NNG
녀석	녀석/NNB
녀중	녀/NNG + 중/NNB
동이	동이/NNG
동작	동작/NNG
되씩	되/NNB + 씩/XSN
국행	국행/NNG
두령	두령/NNG
두름	두름/NNB
마당	마당/NNB
밀리	밀리/NNB
단식	단식/NNG
복식	복식/NNG
단씩	단/NNG + 씩/XSN
단어	단어/NNG
만건	만/NR + 건/NNB
대0	대/NNB + 0/NR
개縣	개/NNB + 縣/SH
만결	만/NR + 결/NNB
만곳	만/NR + 곳/NNG
공기	공기/NNG
단위	단위/NNG
개은	개/NNB + 은/NNG
군단	군단/NNG
두씩	두/NNB + 씩/XSN
공단	공단/NNG
간반	간/NNB + 반/NNG
두품	두품/NNG
둘씩	둘/NR + 씩/XSN
單位	單位/SH
가구	가구/NNG
백자	백/NR + 자/NNG
드럼	드럼/NNG
득점	득점/NNG
만부	만/NR + 부/NNB
만권	만/NR + 권/NNB
고모	고모/NNG
대목	대목/NNG
개구	개/NNB + 구/NNG
막극	막/NNG + 극/NNG
단장	단장/NNG
단전	단전/NNG
복자	복자/NNG
바늘	바늘/NNG
바다	바다/NNG
단지	단지/NNG
마디	마디/NNG
등국	등국/NNG
만분	만/NR + 분/XSN
개장	개/NNB + 장/NNG
등군	등군/NNG
등급	등급/NNG
만콜	만/NR + 콜/NNG
본과	본과/NNG
군데	군데/NNB
본부	본부/NNG
볼넷	볼넷/NNG
개점	개/NNB + 점/NNG
등분	등분/NNG
볼트	볼트/NNB
등상	등/NNB + 상/NNG
단쯤	단/NNB + 쯤/XSN
바퀴	바퀴/NNB
바트	바트/NNG
개홀	개/NNB + 홀/NNG
천개	천/NR + 개/NNB
개조	개/NNB + 조/NNB
천건	천/NR + 건/NNB
천권	천/NR + 권/NNB
천년	천/NR + 년/NNB
만큼	만큼/NNB
대문	대문/NNG
만불	만/NR + 불/NNB
봉인	봉인/NNG
게임	게임/NNG
억갑	억/NR + 갑/NNG
억개	억/NR + 개/NNB
천대	천/NR + 대/NNB
억건	억/NR + 건/NNB
천량	천/NR + 량/NNB
억년	억/NR + 년/NNB
천리	천/NR + 리/NNB
가닥	가닥/NNG
봉지	봉지/NNG
령씩	령/NNB + 씩/XSN
천만	천만/NNG
천만	천만/NR
만톤	만/NR + 톤/NNB
만통	만/NR + 통/NNB
등석	등/NNB + 석/NNG
억대	억/NR + 대/XSN
억만	억만/NR
억명	억/NR + 명/NNB
答식	答/SH + 식/NNB
세대	세대/NNG
억번	억/NR + 번/NNB
억병	억/NR + 병/NNG
억분	억/NR + 분/NNB
억불	억/NR + 불/NNB
억弗	억/NR + 弗/SH
億弗	億弗/SH
달치	달/NNB + 치/XSN
백장	백/NR + 장/NNB
세등	세/NNB + 등/NNB
공도	공도/NNG
공때	공/NNG + 때/NNG
단통	단통/NNG
단팀	단/NNG + 팀/NNG
억살	억/NR + 살/NNB
세때	세/NNB + 때/NNG
천면	천/NR + 면/NNG
천명	천/NR + 명/NNB
만년	만/NR + 년/NNB
만편	만/NR + 편/NNB
억쌍	억/NR + 쌍/NNG
억씩	억/NR + 씩/XSN
세리	세리/NNB
천문	천/NR + 문/NNG
억엔	억/NR + 엔/NNB
억여	억/NR + 여/XSN
천발	천/NR + 발/NNB
천벌	천/NR + 벌/NNB
천본	천/NR + 본/NNB
천봉	천/NR + 봉/NNG
천부	천/NR + 부/NNB
천분	천/NR + 분/XSN
천불	천/NR + 불/NNB
천弗	천/NR + 弗/SH
만평	만/NR + 평/NNB
배폭	배/NNG + 폭/NNB
세마	세/NNB + 마/NNG
년작	년/NNB + 작/NNG
년장	년/NNB + 장/NNG
천실	천/NR + 실/NNG
천쌍	천/NR + 쌍/NNG
천어	천/NR + 어/NNG
천억	천억/NR
억원	억/NR + 원/NNB
억元	억/NR + 元/SH
萬坪	萬坪/SH
백점	백/NR + 점/NNB
백접	백/NR + 접/NNB
세손	세손/NNG
부당	부/NNB + 당/XSN
부대	부대/NNG
세전	세/NNB + 전/NNG
세조	세/NNB + 조/NNG
만단	만/NR + 단/NNB
천엔	천/NR + 엔/NNB
천여	천/NR + 여/XSN
부두	부두/NNG
세쯤	세/NNB + 쯤/XSN
억인	억/NR + 인/NNG
억잔	억/NR + 잔/NNG
억장	억/NR + 장/NNB
억정	억/NR + 정/NNB
억주	억/NR + 주/NNG
억중	억/NR + 중/NNB
년전	년/NNB + 전/NNG
부락	부락/NNG
등성	등성/NNB
억쯤	억/NR + 쯤/XSN
세트	세트/NNG
억통	억/NR + 통/NNB
대1	대/NNB + 1/SN
세포	세포/NNG
백조	백조/NR
억평	억/NR + 평/NNB
센터	센터/NNG
억g	억/NR + g/SL
억m	억/NR + m/SL
억t	억/NR + t/SL
센트	센트/NNB
언니	언니/NNG
언더	언더/NNG
부문	부문/NNG
천원	천/NR + 원/NNB
만석	만/NR + 석/NNB
언시	언/NNG + 시/NNG
센티	센티/NNB
경제	경제/NNG
만섬	만/NR + 섬/NNB
천인	천/NR + 인/NNG
천자	천/NR + 자/NNG
천장	천/NR + 장/NNB
천장	천장/NNG
천주	천/NR + 주/NNB
천질	천/NR + 질/NNB
천차	천/NR + 차/NNB
천채	천/NR + 채/NNB
천컷	천/NR + 컷/NNG
엔당	엔/NNB + 당/XSN
천킵	천/NR + 킵/NNG
천톤	천/NR + 톤/NNB
천통	천/NR + 통/NNB
천평	천/NR + 평/NNB
천坪	천/NR + 坪/SH
엔대	엔/NNB + 대/XSN
천호	천/NR + 호/NNB
천회	천/NR + 회/NNB
엔진	엔진/NNG
년래	년/NNB + 래/NNG
개공	개/NNB + 공/NNG
천m	천/NR + m/SL
천t	천/NR + t/SL
개과	개/NNB + 과/NNG
여간	여/XSN + 간/NNB
여개	여/XSN + 개/NNB
청사	청사/NNG
체급	체급/NNG
여개	여/XSN + 개국/NNB
체제	체제/NNG
부부	부부/NNG
초간	초/NNB + 간/NNB
초간	초/NNB + 간/NNG
초당	초/NNB + 당/XSN
초대	초/NNB + 대/XSN
소경	소경/NNG
초만	초/NNB + 만/JX
百兆	百兆/SH
초소	초소/NNG
초속	초/NNB + 속/NNG
초씩	초/NNB + 씩/XSN
초전	초/NNB + 전/NNG
만표	만/NR + 표/NNG
초쯤	초/NNB + 쯤/XSN
초차	초/NNB + 차/NNG
소년	소년/NNG
촌네	촌/NNB + 네/XSN
소대	소대/NNG
촌락	촌락/NNG
촌씩	촌/NNB + 씩/XSN
부분	부분/NNG
촌집	촌/NNB + 집/NNG
촌쯤	촌/NNB + 쯤/NNB
총사	총사/NNG
총장	총장/NNG
총재	총재/NNG
추경	추경/NNG
달간	달/NNG + 간/NNG
측성	측/NNB + 성/NNG
층간	층/XSN + 간/NNB
여건	여/XSN + 건/NNB
여곡	여/XSN + 곡/NNG
층단	층/NNG + 단/NNG
층단	층단/NNG
여곳	여/XSN + 곳/NNG
소리	소리/NNG
여국	여/XSN + 국/NNG
여권	여/XSN + 권/NNB
층밥	층/NNG + 밥/NNG
층방	층/NNG + 방/NNG
對1	對/SH + 1/SN
방울	방울/NNG
여기	여/XSN + 기/NNB
층씩	층/NNG + 씩/XSN
여길	여/XSN + 길/NNB
층전	층/NNB + 전/NNG
여년	여/XSN + 년/NNB
속당	속/NNB + 당/XSN
층집	층/NNG + 집/NNG
속당	속/NNG + 당/XSN
층쯤	층/NNG + 쯤/XSN
층탑	층/NNG + 탑/NNG
만명	만/NR + 명/NNB
부씩	부/NNB + 씩/XSN
치쯤	치/NNB + 쯤/NNG
송이	송이/NNG
칠년	칠/NR + 년/NNB
칠백	칠백/NR
칠십	칠십/NR
칠일	칠/NR + 일/NNB
칠천	칠천/NR
칠팔	칠팔/NR
여단	여단/NNG
여대	여/XSN + 대/NNB
칸쯤	칸/NNG + 쯤/XSN
달라	달라/NNB
여대	여대/NNG
캐럿	캐럿/NNG
커트	커트/NNG
여동	여/XSN + 동/NNB
여두	여/XSN + 두/NNB
켤레	켤레/NNB
코스	코스/NNG
쿼터	쿼터/NNG
큐핏	큐핏/NNB
수년	수년/NNG
백개	백/NR + 개/NNB
킬로	킬로/NNB
여리	여/XSN + 리/NNB
달러	달러/NNB
백종	백/NR + 종/NNG
부자	부자/NNG
백건	백/NR + 건/NNB
백골	백/NR + 골/NNG
등신	등신/NNG
여만	여/XSN + 만/NR
수능	수능/NNG
백곳	백/NR + 곳/NNG
수만	수/NNB + 만/NNB
백관	백/NR + 관/NNB
백권	백/NR + 권/NNB
타석	타석/NNG
부작	부/NNB + 작/NNG
타수	타수/NNG
마력	마력/NNB
부장	부장/NNG
타스	타스/NNB
수석	수석/NNG
타자	타자/NNG
타점	타점/NNG
타째	타/NNG + 째/XSN
타차	타/NNG + 차/NNG
백주	백/NR + 주/NNG
륙세	륙/NR + 세/NNB
수씩	수/NNB + 씩/XSN
택시	택시/NNG
수업	수업/NNG
백기	백/NR + 기/NNB
토막	토막/NNG
톤급	톤/NNB + 급/NNG
톤당	톤/NNB + 당/XSN
톤씩	톤/NNB + 씩/XSN
수준	수준/NNG
통씩	통/NNB + 씩/XSN
통장	통장/NNG
통화	통화/NNG
여명	여/XSN + 명/NNB
투신	투신/NNG
수천	수천/NR
트랙	트랙/NNG
숙부	숙부/NNG
특보	특보/NNG
특전	특전/NNG
특품	특품/NNG
팀씩	팀/NNG + 씩/XSN
팀장	팀장/NNG
여발	여/XSN + 발/NNB
개당	개/NNB + 당/XSN
파전	파/NNG + 전/NNG
여번	여/XSN + 번/NNB
여벌	여/XSN + 벌/NNB
만대	만/NR + 대/NNB
여부	여/XSN + 부/NNB
패씩	패/NNB + 씩/XSN
여분	여/XSN + 분/NNB
부제	부제/NNG
개대	개/NNB + 대/NNG
백년	백/NR + 년/NNB
백석	백/NR + 석/NNB
순서	순서/NNG
순위	순위/NNG
퍼트	퍼트/NNG
페니	페니/NNG
페소	페소/NNG
여사	여사/NNG
여석	여/XSN + 석/NNB
여섯	여섯/NR
펜스	펜스/NNB
백단	백/NR + 단/NNB
편꼴	편/NNB + 꼴/XSN
편당	편/NNB + 당/XSN
편본	편/NNG + 본/NNG
편분	편/NNB + 분/XSN
편성	편성/NNG
편씩	편/NNB + 씩/XSN
편쯤	편/NNB + 쯤/XSN
평당	평/NNB + 당/XSN
평대	평/NNB + 대/XSN
여수	여/XSN + 수/NNB
평방	평방/NNG
經濟	經濟/SH
여억	여/XSN + 억/NR
평생	평생/NNG
부쪽	부/NNB + 쪽/NNB
부쯤	부/NNB + 쯤/XSN
평쯤	평/NNB + 쯤/XSN
만호	만/NR + 호/NNB
평형	평/NNB + 형/XSN
년제	년/NNB + 제/XSN
백대	백/NR + 대/NNB
숟갈	숟갈/NNG
여원	여/XSN + 원/NNB
폐수	폐수/NNG
포기	포기/NNG
여일	여/XSN + 일/NNB
포당	포/NNG + 당/XSN
포대	포대/NNG
포병	포병/NNG
백대	백/NR + 대/NNG
폭반	폭/NNB + 반/NNG
폭반	폭/NNG + 반/NNG
쉰살	쉰/NR + 살/NNB
폭씩	폭/NNB + 씩/XSN
여자	여자/NNG
폭포	폭포/NNG
표차	표/NNG + 차/NNG
품계	품계/NNG
품관	품관/NNG
품목	품목/NNG
품종	품종/NNG
대별	대별/NNG
풍상	풍상/NNG
프랑	프랑/NNB
등실	등/NNB + 실/NNG
여장	여/XSN + 장/NNB
백대	백/NR + 대/XSN
여점	여/XSN + 점/NNB
프로	프로/NNB
여종	여/XSN + 종/NNG
백도	백/NR + 도/NNB
여집	여/XSN + 집/NNG
백돌	백/NR + 돌/NNG
백리	백/NR + 리/NNB
여쪽	여/XSN + 쪽/NNG
피트	피트/NNB
픽셀	픽셀/NNG
핀트	핀트/NNG
필씩	필/NNB + 씩/XSN
필지	필지/NNB
하나	하나/NR
등품	등품/NNG
하루	하루/NNG
학계	학/NNG + 계/XSN
학과	학과/NNG
학군	학군/NNG
학급	학급/NNG
년력	년/NNB + 력/NNG
여채	여/XSN + 채/NNB
학기	학기/NNG
여척	여/XSN + 척/NNB
여초	여/XSN + 초/NNB
부처	부처/NNG
여칸	여/XSN + 칸/NNG
년만	년/NNB + 만/NNB
여톤	여/XSN + 톤/NNB
학년	학년/NNG
스텝	스텝/NNG
여통	여/XSN + 통/NNB
백만	백만/NR
결당	결/NNB + 당/XSN
여편	여/XSN + 편/NNB
여평	여/XSN + 평/NNB
여표	여/XSN + 표/NNG
여호	여/XSN + 호/NNB
여회	여/XSN + 회/NNB
백쪽	백/NR + 쪽/NNB
여m	여/XSN + m/SL
학도	학도/NNG
학점	학점/NNG
만회	만/NR + 회/NNB
담당	담당/NNG
달째	달/NNG + 째/XSN
백쯤	백/NR + 쯤/XSN
여t	여/XSN + t/SL
한둘	한둘/NR
박스	박스/NNG
역이	역이/NNG
함대	함대/NNG
연결	연결/NNG
연대	연대/NNG
항구	항구/NNG
항목	항목/NNG
項目	項目/SH
항사	항사/NNG
연도	연도/NNG
항차	항차/NNG
해리	해리/NNB
海里	海里/SH
해법	해/NNG + 법/NNG
해안	해안/NNG
해역	해역/NNG
해전	해/NNG + 전/NNG
해체	해체/NNG
행사	행사/NNG
행시	행/NNG + 시/NNG
행씩	행/NNG + 씩/XSN
연방	연방/NNG
만명	만명/NNG
행주	행주/NNP
연속	연속/NNG
만k	만/NR + k/SL
연승	연승/NNG
혁명	혁명/NNG
현금	현금/NNG
현령	현령/NNG
현장	현장/NNG
顯宗	顯宗/SH
백차	백/NR + 차/NNB
형님	형/NNG + 님/XSN
백척	백/NR + 척/NNB
연안	연안/NNG
연장	연장/NNG
호골	호/NNB + 골/NNG
연전	연전/NNG
호기	호/NNB + 기/NNB
호기	호/NNB + 기/NNG
호기	호기/NNG
호당	호/NNB + 당/XSN
호때	호/NNB + 때/NNG
호묘	호/NNB + 묘/NNG
루블	루블/NNG
호방	호/NNB + 방/NNG
연패	연패/NNG
호봉	호봉/NNG
호분	호/NNB + 분/NNG
호뿐	호/NNB + 뿐/NNB
호선	호/NNB + 선/NNG
호선	호선/NNG
호수	호수/NNG
호실	호실/NNG
결씩	결/NNB + 씩/XSN
열사	열사/NNG
호점	호/NNB + 점/NNG
호점	호점/NNG
호정	호/NNB + 정/NNG
열차	열차/NNG
호집	호/NNB + 집/NNG
엿새	엿새/NNG
만엔	만/NR + 엔/NNB
호쪽	호/NNG + 쪽/NNB
호차	호/NNB + 차/NNG
호포	호/NNB + 포/NNG
호흡	호흡/NNG
영리	영리/NNB
홀차	홀/NNG + 차/NNG
홈런	홈런/NNG
영역	영역/NNG
홉씩	홉/NNB + 씩/XSN
마리	마리/NNB
화산	화산/NNP
화음	화음/NNG
환씩	환/NNB + 씩/XSN
영화	영화/NNG
황산	황산/NNP
회계	회계/NNG
만여	만/NR + 여/XSN
회기	회/NNB + 기/NNG
회꼴	회/NNB + 꼴/XSN
회당	회/NNB + 당/XSN
예산	예산/NNG
회때	회/NNB + 때/NNG
회말	회/NNB + 말/NNB
회분	회/NNB + 분/XSN
백초	백/NR + 초/NNB
회선	회선/NNG
회성	회/NNB + 성/XSN
회씩	회/NNB + 씩/XSN
걸음	걸음/NNG
회용	회/NNB + 용/XSN
회전	회전/NNB
회째	회/NNB + 째/XSN
회쪽	회/NNB + 쪽/NNG
회차	회/NNB + 차/NNB
회초	회/NNB + 초/NNB
후반	후반/NNG
후보	후보/NNG
후퇴	후퇴/NNG
오도	오/NR + 도/NNB
흉일	흉일/NNG
A형	A/SL + 형/XSN
백층	백/NR + 층/NNG
BB	BB/SL
개법	개/NNB + 법/NNG
오륙	오륙/NR
Bq	Bq/SL
백수	백/NR + 수/NNB
cc	cc/SL
오만	오만/NR
오백	오백/NR
강국	강국/NNG
오버	오버/NNG
백톤	백/NR + 톤/NNG
Ci	Ci/SL
오빠	오빠/NNG
cm	cm/SL
Cm	Cm/SL
오십	오십/NR
오천	오천/NR
오픈	오픈/NNG
박자	박자/NNG
옥사	옥사/NNG
온스	온스/NNB
만리	만/NR + 리/NNB
올케	올케/NNG
와트	와트/NNB
마일	마일/NNB
왕조	왕조/NNG
DM	DM/SL
DO	DO/SL
년말	년/NNB + 말/NNB
FM	FM/SL
Ft	Ft/SL
g값	g/SL + 값/NNG
g당	g/SL + 당/XSN
g대	g/SL + 대/NNG
g씩	g/SL + 씩/XSN
요소	요소/NNG
Ga	Ga/SL
GB	GB/SL
요인	요인/NNG
ha	ha/SL
Ha	Ha/SL
HU	HU/SL
Hz	Hz/SL
IU	IU/SL
K씨	K/SL + 씨/NNB
우상	우상/NNG
KB	KB/SL
반보	반보/NNB
대3	대/NNB + 3/SN
백편	백/NR + 편/NNB
운동	운동/NNG
kg	kg/SL
Kg	Kg/SL
년뒤	년/NNB + 뒤/NNG
백평	백/NR + 평/NNB
원권	원/NNB + 권/NNG
km	km/SL
Km	Km/SL
km	km/SL
Km	Km/SL
원권	원/NNB + 권/XSN
원꼴	원/NNB + 꼴/XSN
원대	원/NNB + 대/XSN
원代	원/NNB + 代/SH
백표	백/NR + 표/NNG
원선	원/NNB + 선/NNG
원씩	원/NNB + 씩/XSN
루수	루/NNG + 수/NNG
반칙	반칙/NNG
KO	KO/SL
KW	KW/SL
kW	kW/SL
L당	L/SL + 당/XSN
원적	원/NNG + 적/XSN
m2	m/SL + 2/SN
루심	루/NNG + 심/NNG
대4	대/NNB + 4/SN
백엔	백/NR + 엔/NNB
m4	m/SL + 4/SN
원짜	원/NNB + 짜리/XSN +
거리	거리/NNG
원쯤	원/NNB + 쯤/NNG
원쯤	원/NNB + 쯤/XSN
백억	백억/NR
원칙	원칙/NNG
원화	원/NNG + 화/XSN
백회	백/NR + 회/NNB
만t	만/NR + t/SL
년조	년조/NNG
년중	년/NNB + 중/NNB
m당	m/SL + 당/NNG
m당	m/SL + 당/XSN
M등	M/SL + 등/NNB
만발	만/NR + 발/NNB
m씩	m/SL + 씩/XSN
만배	만/NR + 배/NNG
백여	백/NR + 여/XSN
年中	年中/SH
승씩	승/NNB + 씩/XSN
승자	승자/NNG
고주	고주/NNG
m쯤	m/SL + 쯤/NNG
m쯤	m/SL + 쯤/XSN
MB	MB/SL
백매	백/NR + 매/NNB
백명	백/NR + 명/NNB
百명	百/SH + 명/NNB
mg	mg/SL
승째	승/NNB + 째/XSN
년지	년/NNB + 지/NNG
ml	ml/SL
mL	mL/SL
승차	승/NNB + 차/NNG
mm	m/SL + m/SL
mm	mm/SL
발씩	발/NNB + 씩/XSN
강전	강/NNG + 전/NNG
Mt	Mt/SL
Na	Na/SL
ND	ND/SL
nm	nm/SL
OM	OM/SL
륙십	륙십/NR
pg	pg/SL
년째	년/NNB + 째/XSN
년간	년/NNB + 간/NNB
년때	년/NNB + 때/NNG
rd	rd/SL
t급	t/SL + 급/NNG
공주	공주/NNG
학번	학번/NNG
학생	학생/NNG
서기	서기/NNG
단체	단체/NNG
세대	세대/NNG
형제	형제/NNG
주기	주기/NNG
친구	친구/NNG
선배	선배/NNG
후배	후배/NNG
원소	원소/NNG
년생	년/NNB + 생/XSN
층집	층/NNG + 집/NNG
t씩	t/SL + 씩/XSN
t중	t/SL + 중/NNB
말씩	말/NNB + 씩/XSN
년末	년/NNB + 末/SH
th	th/SL
tv	tv/SL
TV	TV/SL
백밖	백/NR + 밖/NNG
UP	UP/SL
uV	uV/SL
라인	라인/NNG
WD	WD/SL
겹집	겹집/NNG
省	省/SH
짐	짐/NNG
﻿가	가/NNG
평	평/NNB
결	결/NNB
집	집/NNB
人	人/SH
각	각/NNG
광	광/NNG
걸	걸/NNG
금	금/NNG
객	객/NNG
룡	룡/NNG
정	정/NNB
語	語/SH
府	府/SH
짝	짝/NNB
꿍	꿍/NNG
폐	폐/NNG
끗	끗/NNB
포	포/NNB
끼	끼/NNG
나	나/NNG
쪽	쪽/NNB
쉰	쉰/NR
폭	폭/NNB
幅	幅/SH
매	매/NNB
쯤	쯤/NNG
차	차/NNB
次	次/SH
심	심/NNG
표	표/NNG
작	작/NNB
푼	푼/NNB
품	품/NNB
색	색/NNG
이	이/NNB
억	억/NR
량	량/NNG
씨	씨/NNB
강	강/NNG
잔	잔/NNG
세	세/NNB
괘	괘/NNG
里	里/SH
때	때/NNG
놈	놈/NNB
장	장/NNB
勞	勞/SH
곱	곱/NNG
倍	倍/SH
핀	핀/NNG
곳	곳/NNG
필	필/NNB
단	단/NNB
百	百/SH
문	문/NNB
億	億/SH
씬	씬/NNG
문	문/NNG
급	급/NNB
계	계/NNG
問	問/SH
교	교/NNB
題	題/SH
국	국/NNB
간	간/NNB
독	독/NNG
승	승/NNB
달	달/NNB
벌	벌/NNB
냥	냥/NNB
례	례/NNG
식	식/NNB
돈	돈/NNB
륜	륜/NNG
당	당/NNG
돌	돌/NNB
량	량/NNB
족	족/NNG
世	世/SH
한	한/NNG
代	代/SH
언	언/NNG
막	막/NNB
분	분/NNB
역	역/NNG
할	할/NNB
役	役/SH
락	락/NNG
함	함/NNG
종	종/NNB
연	연/NNG
歲	歲/SH
합	합/NNG
항	항/NNG
분	분/NNG
구	구/NNB
種	種/SH
만	만/NR
分	分/SH
해	해/NNB
리	리/NNB
몇	몇/NR
명	명/NNB
음	음/NNG
불	불/NNB
輪	輪/SH
조	조/NNB
행	행/NNG
동	동/NNB
엔	엔/NNB
답	답/NNG
궁	궁/NNG
현	현/NNG
縣	縣/SH
區	區/SH
석	석/NNB
위	위/NNB
좌	좌/NNG
형	형/NNG
모	모/NP
엥	엥/NNB
여	여/NNG
뭇	뭇/NNB
호	호/NNB
號	號/SH
주	주/NNB
보	보/NNB
철	철/NNG
공	공/NNG
첩	첩/NNB
周	周/SH
범	범/NNB
週	週/SH
권	권/NNB
초	초/NNB
셋	셋/NR
열	열/NNB
소	소/NNG
기	기/NNB
共	共/SH
미	미/NNG
大	大/SH
막	막/NNG
期	期/SH
착	착/NNG
영	영/NNP
참	참/NNG
위	위/NNG
잎	잎/NNG
홀	홀/NNG
채	채/NNB
촉	촉/NNB
넷	넷/NR
홉	홉/NNB
촌	촌/NNB
촌	촌/NNG
화	화/NNG
자	자/NNB
책	책/NNG
처	처/NNG
환	환/NNB
환	환/NNG
십	십/NR
字	字/SH
회	회/NNB
回	回/SH
예	예/NNG
척	척/NNB
尺	尺/SH
재	재/NNG
삼	삼/NR
삭	삭/NNB
件	件/SH
닢	닢/NNB
충	충/NNG
립	립/NNB
층	층/NNG
과	과/NNG
저	저/NNG
마	마/NNB
오	오/NR
마	마/NNG
건	건/NNB
적	적/NNG
천	천/NNG
속	속/NNB
천	천/NR
획	획/NNG
효	효/NNG
후	후/NNG
속	속/NNG
녀	녀/NNG
千	千/SH
훈	훈/NNG
방	방/NNG
다	다/NNG
a	a/SL
A	A/SL
煮	煮/SH
b	b/SL
B	B/SL
전	전/NNB
악	악/NNG
者	者/SH
面	面/SH
C	C/SL
c	c/SL
류	류/NNG
角	角/SH
되	되/NNB
면	면/NNG
년	년/NNB
두	두/NNB
신	신/NNG
치	치/NNB
안	안/NNG
칙	칙/NNG
번	번/NNB
칠	칠/NR
갑	갑/NNG
백	백/NR
읍	읍/NNG
산	산/NNG
옥	옥/NNG
상	상/NNG
온	온/NNG
D	D/SL
d	d/SL
D	D/SL
알	알/NNB
뿐	뿐/NNB
알	알/NNG
칸	칸/NNG
군	군/NNB
왕	왕/NNG
배	배/NNG
선	선/NNB
솥	솥/NNG
e	e/SL
f	f/SL
F	F/SL
캔	캔/NNG
g	g/SL
련	련/NNG
쇄	쇄/NNG
사	사/NNG
컵	컵/NNG
컷	컷/NNG
수	수/NNB
選	選/SH
H	H/SL
일	일/NNB
年	年/SH
절	절/NNG
軍	軍/SH
I	I/SL
고	고/NNG
K	K/SL
반	반/NNG
둘	둘/NR
죽	죽/NNB
줄	줄/NNB
것	것/NNB
一	一/SH
웅	웅/NNG
원	원/NNB
루	루/NNG
元	元/SH
딸	딸/NNG
중	중/NNB
목	목/NNG
등	등/NNB
黨	黨/SH
타	타/NNG
골	골/NNG
점	점/NNB
극	극/NNG
밍	밍/NNB
액	액/NNG
바	바/NNG
白	白/SH
야	야/NNG
社	社/SH
본	본/NNB
탁	탁/NNG
탄	탄/NNB
L	L/SL
l	l/SL
日	日/SH
名	名/SH
m	m/SL
M	M/SL
탕	탕/NNG
湯	湯/SH
태	태/NNG
관	관/NNB
택	택/NNG
실	실/NNB
개	개/NNB
발	발/NNB
근	근/NNB
관	관/NNG
톤	톤/NNB
월	월/NNB
月	月/SH
경	경/NNG
길	길/NNB
통	통/NNB
김	김/NNP
살	살/NNB
斤	斤/SH
벽	벽/NNG
지	지/NNB
변	변/NNG
숙	숙/NNG
쌍	쌍/NNG
실	실/NNG
병	병/NNG
약	약/NNG
댁	댁/NNG
팀	팀/NNG
낙	낙/NNG
박	박/NNB
파	파/NNG
순	순/NNG
난	난/NNG
말	말/NNB
날	날/NNB
댓	댓/NR
익	익/NNG
판	판/NNB
시	시/NNB
방	방/NNB
팔	팔/NR
덕	덕/NNG
n	n/SL
의	의/NNG
패	패/NNB
O	O/SL
봉	봉/NNG
P	P/SL
p	p/SL
팩	팩/NNG
時	時/SH
양	양/NNB
R	R/SL
직	직/NNG
검	검/NNG
인	인/NNB
S	S/SL
겹	겹/NNG
t	t/SL
T	T/SL
대	대/NNB
진	진/NNG
도	도/NNB
남	남/NNG
곡	곡/NNG
섬	섬/NNB
묘	묘/NNG
弗	弗/SH
度	度/SH
편	편/NNB
V	V/SL
성	성/NNG
W	W/SL
무	무/NNG
새	새/NNB
부	부/NNB
%	%/SL
x	x/SL
