가빈	가빈/NNP
가빈	가빈/NNP
가영	가영/NNP
가현	가현/NNP
간난	간난/NNP
갑룡	갑룡/NNP
갑수	갑수/NNP
갑숙	갑숙/NNP
갑순	갑순/NNP
강길	강길/NNP
강래	강래/NNP
강룡	강룡/NNP
강문	강문/NNP
강백	강백/NNP
강석	강석/NNP
강섭	강섭/NNP
강수	강수/NNP
강숙	강숙/NNP
강순	강순/NNP
강신	강신/NNP
강영	강영/NNP
강욱	강욱/NNP
강윤	강윤/NNP
강재	강재/NNP
강혁	강혁/NNP
강현	강현/NNP
강호	강호/NNP
강환	강환/NNP
강훈	강훈/NNP
강희	강희/NNP
건래	건래/NNP
건모	건모/NNP
건상	건상/NNP
건영	건영/NNP
건오	건오/NNP
건우	건우/NNP
건웅	건웅/NNP
건일	건일/NNP
건장	건장/NNP
건재	건재/NNP
건종	건종/NNP
건준	건준/NNP
건중	건중/NNP
건차	건차/NNP
건찬	건찬/NNP
건창	건창/NNP
건철	건철/NNP
건탁	건탁/NNP
건하	건하/NNP
건호	건호/NNP
건홍	건홍/NNP
건환	건환/NNP
건휴	건휴/NNP
건희	건희/NNP
격호	격호/NNP
견대	견대/NNP
경곤	경곤/NNP
경구	경구/NNP
경국	경국/NNP
경규	경규/NNP
경균	경균/NNP
경근	경근/NNP
경기	경기/NNP
경남	경남/NNP
경대	경대/NNP
경덕	경덕/NNP
경락	경락/NNP
경란	경란/NNP
경래	경래/NNP
경련	경련/NNP
경렬	경렬/NNP
경례	경례/NNP
경로	경로/NNP
경록	경록/NNP
경률	경률/NNP
경린	경린/NNP
경림	경림/NNP
경모	경모/NNP
경목	경목/NNP
경무	경무/NNP
경묵	경묵/NNP
경미	경미/NNP
경민	경민/NNP
경백	경백/NNP
경복	경복/NNP
경분	경분/NNP
경빈	경빈/NNP
경상	경상/NNP
경석	경석/NNP
경선	경선/NNP
경섭	경섭/NNP
경성	경성/NNP
경세	경세/NNP
경수	경수/NNP
경숙	경숙/NNP
경순	경순/NNP
경식	경식/NNP
경신	경신/NNP
경실	경실/NNP
경아	경아/NNP
경안	경안/NNP
경애	경애/NNP
경언	경언/NNP
경업	경업/NNP
경역	경역/NNP
경연	경연/NNP
경엽	경엽/NNP
경오	경오/NNP
경옥	경옥/NNP
경완	경완/NNP
경요	경요/NNP
경욱	경욱/NNP
경운	경운/NNP
경원	경원/NNP
경일	경일/NNP
경자	경자/NNP
경재	경재/NNP
경전	경전/NNP
경조	경조/NNP
경종	경종/NNP
경주	경주/NNP
경준	경준/NNP
경진	경진/NNP
경찬	경찬/NNP
경창	경창/NNP
경채	경채/NNP
경천	경천/NNP
경철	경철/NNP
경춘	경춘/NNP
경태	경태/NNP
경택	경택/NNP
경팔	경팔/NNP
경포	경포/NNP
경표	경표/NNP
경필	경필/NNP
경하	경하/NNP
경한	경한/NNP
경현	경현/NNP
경혜	경혜/NNP
경호	경호/NNP
경화	경화/NNP
경환	경환/NNP
경후	경후/NNP
경훈	경훈/NNP
경희	경희/NNP
계관	계관/NNP
계남	계남/NNP
계락	계락/NNP
계순	계순/NNP
고영	고영/NNP
고운	고운/NNP
고은	고은/NNP
공진	공진/NNP
공필	공필/NNP
공희	공희/NNP
관경	관경/NNP
관구	관구/NNP
관규	관규/NNP
관근	관근/NNP
관모	관모/NNP
관석	관석/NNP
관섭	관섭/NNP
관수	관수/NNP
관순	관순/NNP
관식	관식/NNP
관열	관열/NNP
관영	관영/NNP
관옥	관옥/NNP
관우	관우/NNP
관위	관위/NNP
관재	관재/NNP
관준	관준/NNP
관천	관천/NNP
관태	관태/NNP
관학	관학/NNP
관헌	관헌/NNP
관호	관호/NNP
관희	관희/NNP
광규	광규/NNP
광균	광균/NNP
광기	광기/NNP
광남	광남/NNP
광대	광대/NNP
광덕	광덕/NNP
광두	광두/NNP
광락	광락/NNP
광래	광래/NNP
광렬	광렬/NNP
광로	광로/NNP
광린	광린/NNP
광림	광림/NNP
광모	광모/NNP
광민	광민/NNP
광범	광범/NNP
광보	광보/NNP
광복	광복/NNP
광부	광부/NNP
광빈	광빈/NNP
광서	광서/NNP
광석	광석/NNP
광선	광선/NNP
광섭	광섭/NNP
광성	광성/NNP
광수	광수/NNP
광순	광순/NNP
광식	광식/NNP
광억	광억/NNP
광언	광언/NNP
광연	광연/NNP
광열	광열/NNP
광엽	광엽/NNP
광영	광영/NNP
광오	광오/NNP
광옥	광옥/NNP
광요	광요/NNP
광우	광우/NNP
광욱	광욱/NNP
광운	광운/NNP
광웅	광웅/NNP
광원	광원/NNP
광인	광인/NNP
광일	광일/NNP
광임	광임/NNP
광자	광자/NNP
광재	광재/NNP
광정	광정/NNP
광제	광제/NNP
광조	광조/NNP
광종	광종/NNP
광주	광주/NNP
광준	광준/NNP
광중	광중/NNP
광진	광진/NNP
광천	광천/NNP
광철	광철/NNP
광춘	광춘/NNP
광태	광태/NNP
광택	광택/NNP
광표	광표/NNP
광필	광필/NNP
광하	광하/NNP
광한	광한/NNP
광해	광해/NNP
광혁	광혁/NNP
광현	광현/NNP
광형	광형/NNP
광호	광호/NNP
광환	광환/NNP
광회	광회/NNP
광훈	광훈/NNP
광휘	광휘/NNP
광희	광희/NNP
교빈	교빈/NNP
교성	교성/NNP
교순	교순/NNP
교일	교일/NNP
교준	교준/NNP
구모	구모/NNP
구범	구범/NNP
구병	구병/NNP
구복	구복/NNP
구빈	구빈/NNP
구선	구선/NNP
구열	구열/NNP
구영	구영/NNP
구일	구일/NNP
구종	구종/NNP
구중	구중/NNP
구현	구현/NNP
구희	구희/NNP
국병	국병/NNP
국선	국선/NNP
국섭	국섭/NNP
국성	국성/NNP
국신	국신/NNP
국역	국역/NNP
국염	국염/NNP
국영	국영/NNP
국원	국원/NNP
국종	국종/NNP
국지	국지/NNP
국진	국진/NNP
국창	국창/NNP
국충	국충/NNP
국태	국태/NNP
국필	국필/NNP
국한	국한/NNP
국현	국현/NNP
국형	국형/NNP
국환	국환/NNP
국회	국회/NNP
국희	국희/NNP
군봉	군봉/NNP
군성	군성/NNP
군천	군천/NNP
군총	군총/NNP
궁복	궁복/NNP
궁우	궁우/NNP
권모	권모/NNP
권무	권무/NNP
권상	권상/NNP
권석	권석/NNP
권숙	권숙/NNP
권순	권순/NNP
권열	권열/NNP
권우	권우/NNP
권준	권준/NNP
권진	권진/NNP
권택	권택/NNP
권하	권하/NNP
권효	권효/NNP
권흠	권흠/NNP
권희	권희/NNP
귀남	귀남/NNP
귀매	귀매/NNP
귀민	귀민/NNP
귀병	귀병/NNP
귀봉	귀봉/NNP
귀선	귀선/NNP
귀수	귀수/NNP
귀숙	귀숙/NNP
귀순	귀순/NNP
귀영	귀영/NNP
귀옥	귀옥/NNP
귀자	귀자/NNP
귀정	귀정/NNP
귀중	귀중/NNP
귀현	귀현/NNP
귀호	귀호/NNP
귀환	귀환/NNP
귀훈	귀훈/NNP
귀희	귀희/NNP
규강	규강/NNP
규경	규경/NNP
규광	규광/NNP
규권	규권/NNP
규남	규남/NNP
규덕	규덕/NNP
규동	규동/NNP
규락	규락/NNP
규룡	규룡/NNP
규리	규리/NNP
규명	규명/NNP
규민	규민/NNP
규백	규백/NNP
규병	규병/NNP
규보	규보/NNP
규복	규복/NNP
규빈	규빈/NNP
규상	규상/NNP
규서	규서/NNP
규석	규석/NNP
규선	규선/NNP
규설	규설/NNP
규섭	규섭/NNP
규성	규성/NNP
규수	규수/NNP
규술	규술/NNP
규식	규식/NNP
규양	규양/NNP
규엽	규엽/NNP
규영	규영/NNP
규옥	규옥/NNP
규완	규완/NNP
규욱	규욱/NNP
규운	규운/NNP
규원	규원/NNP
규응	규응/NNP
규익	규익/NNP
규일	규일/NNP
규자	규자/NNP
규장	규장/NNP
규전	규전/NNP
규정	규정/NNP
규주	규주/NNP
규진	규진/NNP
규찬	규찬/NNP
규창	규창/NNP
규채	규채/NNP
규철	규철/NNP
규칠	규칠/NNP
규태	규태/NNP
규택	규택/NNP
규하	규하/NNP
규학	규학/NNP
규한	규한/NNP
규항	규항/NNP
규헌	규헌/NNP
규현	규현/NNP
규형	규형/NNP
규호	규호/NNP
규홍	규홍/NNP
규화	규화/NNP
규환	규환/NNP
규황	규황/NNP
규효	규효/NNP
규훈	규훈/NNP
규희	규희/NNP
균삼	균삼/NNP
균영	균영/NNP
균환	균환/NNP
극기	극기/NNP
극렬	극렬/NNP
극례	극례/NNP
극로	극로/NNP
극수	극수/NNP
극찬	극찬/NNP
근교	근교/NNP
근덕	근덕/NNP
근량	근량/NNP
근모	근모/NNP
근미	근미/NNP
근배	근배/NNP
근삼	근삼/NNP
근상	근상/NNP
근섭	근섭/NNP
근숙	근숙/NNP
근술	근술/NNP
근식	근식/NNP
근안	근안/NNP
근애	근애/NNP
근열	근열/NNP
근영	근영/NNP
근우	근우/NNP
근일	근일/NNP
근종	근종/NNP
근주	근주/NNP
근준	근준/NNP
근진	근진/NNP
근찬	근찬/NNP
근창	근창/NNP
근천	근천/NNP
근철	근철/NNP
근태	근태/NNP
근택	근택/NNP
근표	근표/NNP
근필	근필/NNP
근해	근해/NNP
근형	근형/NNP
근혜	근혜/NNP
근호	근호/NNP
근홍	근홍/NNP
근화	근화/NNP
근환	근환/NNP
근후	근후/NNP
근희	근희/NNP
금덕	금덕/NNP
금라	금라/NNP
금란	금란/NNP
금래	금래/NNP
금례	금례/NNP
금룡	금룡/NNP
금보	금보/NNP
금복	금복/NNP
금봉	금봉/NNP
금분	금분/NNP
금산	금산/NNP
금석	금석/NNP
금성	금성/NNP
금세	금세/NNP
금숙	금숙/NNP
금순	금순/NNP
금식	금식/NNP
금실	금실/NNP
금역	금역/NNP
금옥	금옥/NNP
금원	금원/NNP
금자	금자/NNP
금종	금종/NNP
금주	금주/NNP
금진	금진/NNP
금채	금채/NNP
금철	금철/NNP
금현	금현/NNP
금호	금호/NNP
금화	금화/NNP
금희	금희/NNP
긍규	긍규/NNP
긍익	긍익/NNP
긍희	긍희/NNP
기균	기균/NNP
기남	기남/NNP
기덕	기덕/NNP
기룡	기룡/NNP
기민	기민/NNP
기범	기범/NNP
기병	기병/NNP
기성	기성/NNP
기수	기수/NNP
기숙	기숙/NNP
기순	기순/NNP
기승	기승/NNP
기식	기식/NNP
기연	기연/NNP
기열	기열/NNP
기엽	기엽/NNP
기영	기영/NNP
기옥	기옥/NNP
기우	기우/NNP
기욱	기욱/NNP
기웅	기웅/NNP
기인	기인/NNP
기재	기재/NNP
기전	기전/NNP
기정	기정/NNP
기조	기조/NNP
기주	기주/NNP
기준	기준/NNP
기중	기중/NNP
기찬	기찬/NNP
기창	기창/NNP
기천	기천/NNP
기철	기철/NNP
기총	기총/NNP
기춘	기춘/NNP
기침	기침/NNP
기탁	기탁/NNP
기태	기태/NNP
기택	기택/NNP
기평	기평/NNP
기풍	기풍/NNP
기헌	기헌/NNP
기혁	기혁/NNP
기현	기현/NNP
기협	기협/NNP
기형	기형/NNP
기호	기호/NNP
기홍	기홍/NNP
기화	기화/NNP
기환	기환/NNP
기훈	기훈/NNP
길남	길남/NNP
길례	길례/NNP
길산	길산/NNP
길상	길상/NNP
길선	길선/NNP
길성	길성/NNP
길수	길수/NNP
길순	길순/NNP
길승	길승/NNP
길식	길식/NNP
길연	길연/NNP
길영	길영/NNP
길우	길우/NNP
길운	길운/NNP
길웅	길웅/NNP
길원	길원/NNP
길윤	길윤/NNP
길자	길자/NNP
길재	길재/NNP
길전	길전/NNP
길정	길정/NNP
길종	길종/NNP
길주	길주/NNP
길준	길준/NNP
길중	길중/NNP
길창	길창/NNP
길채	길채/NNP
길천	길천/NNP
길철	길철/NNP
길택	길택/NNP
길표	길표/NNP
길현	길현/NNP
길호	길호/NNP
길홍	길홍/NNP
길화	길화/NNP
길환	길환/NNP
길훈	길훈/NNP
끝별	끝별/NNP
나라	나라/NNP
나래	나래/NNP
나미	나미/NNP
나연	나연/NNP
나영	나영/NNP
나희	나희/NNP
낙경	낙경/NNP
낙구	낙구/NNP
낙균	낙균/NNP
낙기	낙기/NNP
낙범	낙범/NNP
낙성	낙성/NNP
낙연	낙연/NNP
낙인	낙인/NNP
낙주	낙주/NNP
낙필	낙필/NNP
낙현	낙현/NNP
낙호	낙호/NNP
난숙	난숙/NNP
난심	난심/NNP
난영	난영/NNP
난하	난하/NNP
난헌	난헌/NNP
난희	난희/NNP
날미	날미/NNP
남교	남교/NNP
남구	남구/NNP
남규	남규/NNP
남기	남기/NNP
남두	남두/NNP
남례	남례/NNP
남문	남문/NNP
남배	남배/NNP
남범	남범/NNP
남복	남복/NNP
남석	남석/NNP
남선	남선/NNP
남섭	남섭/NNP
남수	남수/NNP
남숙	남숙/NNP
남순	남순/NNP
남식	남식/NNP
남역	남역/NNP
남열	남열/NNP
남옥	남옥/NNP
남욱	남욱/NNP
남운	남운/NNP
남원	남원/NNP
남윤	남윤/NNP
남일	남일/NNP
남전	남전/NNP
남조	남조/NNP
남종	남종/NNP
남주	남주/NNP
남준	남준/NNP
남진	남진/NNP
남천	남천/NNP
남철	남철/NNP
남풍	남풍/NNP
남헌	남헌/NNP
남현	남현/NNP
남형	남형/NNP
남호	남호/NNP
남홍	남홍/NNP
남희	남희/NNP
노성	노성/NNP
노순	노순/NNP
노영	노영/NNP
노우	노우/NNP
노준	노준/NNP
노춘	노춘/NNP
노협	노협/NNP
녹영	녹영/NNP
녹주	녹주/NNP
농주	농주/NNP
능삼	능삼/NNP
능화	능화/NNP
능환	능환/NNP
다비	다비/NNP
다빈	다빈/NNP
다산	다산/NNP
다선	다선/NNP
다솔	다솔/NNP
다영	다영/NNP
다운	다운/NNP
다은	다은/NNP
다훈	다훈/NNP
다희	다희/NNP
달영	달영/NNP
달우	달우/NNP
달재	달재/NNP
달중	달중/NNP
달현	달현/NNP
달호	달호/NNP
담희	담희/NNP
대건	대건/NNP
대경	대경/NNP
대규	대규/NNP
대균	대균/NNP
대근	대근/NNP
대길	대길/NNP
대섭	대섭/NNP
대성	대성/NNP
대승	대승/NNP
대연	대연/NNP
대엽	대엽/NNP
대영	대영/NNP
대완	대완/NNP
대우	대우/NNP
대욱	대욱/NNP
대원	대원/NNP
대윤	대윤/NNP
대은	대은/NNP
대익	대익/NNP
대인	대인/NNP
대일	대일/NNP
대정	대정/NNP
대종	대종/NNP
대준	대준/NNP
대중	대중/NNP
대진	대진/NNP
대징	대징/NNP
대천	대천/NNP
대철	대철/NNP
대하	대하/NNP
대현	대현/NNP
대호	대호/NNP
대홍	대홍/NNP
대훈	대훈/NNP
대휘	대휘/NNP
대흠	대흠/NNP
대흥	대흥/NNP
대희	대희/NNP
덕경	덕경/NNP
덕구	덕구/NNP
덕규	덕규/NNP
덕균	덕균/NNP
덕기	덕기/NNP
덕남	덕남/NNP
덕령	덕령/NNP
덕룡	덕룡/NNP
덕률	덕률/NNP
덕림	덕림/NNP
덕무	덕무/NNP
덕배	덕배/NNP
덕연	덕연/NNP
덕영	덕영/NNP
덕완	덕완/NNP
덕우	덕우/NNP
덕웅	덕웅/NNP
덕윤	덕윤/NNP
덕인	덕인/NNP
덕일	덕일/NNP
덕자	덕자/NNP
덕재	덕재/NNP
덕전	덕전/NNP
덕제	덕제/NNP
덕조	덕조/NNP
덕주	덕주/NNP
덕준	덕준/NNP
덕중	덕중/NNP
덕진	덕진/NNP
덕천	덕천/NNP
덕칠	덕칠/NNP
덕필	덕필/NNP
덕향	덕향/NNP
덕헌	덕헌/NNP
덕현	덕현/NNP
덕형	덕형/NNP
덕홍	덕홍/NNP
덕화	덕화/NNP
덕환	덕환/NNP
덕훈	덕훈/NNP
덕흥	덕흥/NNP
덕희	덕희/NNP
도건	도건/NNP
도관	도관/NNP
도광	도광/NNP
도규	도규/NNP
도길	도길/NNP
도빈	도빈/NNP
도순	도순/NNP
도언	도언/NNP
도연	도연/NNP
도영	도영/NNP
도옥	도옥/NNP
도욱	도욱/NNP
도윤	도윤/NNP
도준	도준/NNP
도진	도진/NNP
도창	도창/NNP
도철	도철/NNP
도향	도향/NNP
도헌	도헌/NNP
도혁	도혁/NNP
도현	도현/NNP
도형	도형/NNP
도화	도화/NNP
도환	도환/NNP
도후	도후/NNP
도훈	도훈/NNP
도흠	도흠/NNP
돈민	돈민/NNP
돈영	돈영/NNP
돈웅	돈웅/NNP
돈익	돈익/NNP
돈중	돈중/NNP
돈혁	돈혁/NNP
돈회	돈회/NNP
돈희	돈희/NNP
돌석	돌석/NNP
돌쇠	돌쇠/NNP
동강	동강/NNP
동건	동건/NNP
동걸	동걸/NNP
동곤	동곤/NNP
동관	동관/NNP
동광	동광/NNP
동구	동구/NNP
동국	동국/NNP
동권	동권/NNP
동규	동규/NNP
동극	동극/NNP
동근	동근/NNP
동기	동기/NNP
동길	동길/NNP
동량	동량/NNP
동렬	동렬/NNP
동록	동록/NNP
동룡	동룡/NNP
동률	동률/NNP
동림	동림/NNP
동민	동민/NNP
동범	동범/NNP
동복	동복/NNP
동빈	동빈/NNP
동삼	동삼/NNP
동석	동석/NNP
동선	동선/NNP
동섭	동섭/NNP
동성	동성/NNP
동수	동수/NNP
동숙	동숙/NNP
동순	동순/NNP
동신	동신/NNP
동연	동연/NNP
동열	동열/NNP
동엽	동엽/NNP
동영	동영/NNP
동오	동오/NNP
동옥	동옥/NNP
동완	동완/NNP
동요	동요/NNP
동우	동우/NNP
동욱	동욱/NNP
동운	동운/NNP
동웅	동웅/NNP
동원	동원/NNP
동윤	동윤/NNP
동익	동익/NNP
동인	동인/NNP
동일	동일/NNP
동자	동자/NNP
동장	동장/NNP
동재	동재/NNP
동정	동정/NNP
동조	동조/NNP
동주	동주/NNP
동준	동준/NNP
동직	동직/NNP
동진	동진/NNP
동집	동집/NNP
동찬	동찬/NNP
동채	동채/NNP
동천	동천/NNP
동철	동철/NNP
동춘	동춘/NNP
동팔	동팔/NNP
동표	동표/NNP
동필	동필/NNP
동하	동하/NNP
동학	동학/NNP
동헌	동헌/NNP
동혁	동혁/NNP
동현	동현/NNP
동형	동형/NNP
동호	동호/NNP
동홍	동홍/NNP
동환	동환/NNP
동효	동효/NNP
동후	동후/NNP
동훈	동훈/NNP
동휘	동휘/NNP
동흔	동흔/NNP
동희	동희/NNP
두관	두관/NNP
두금	두금/NNP
두기	두기/NNP
두남	두남/NNP
두미	두미/NNP
두병	두병/NNP
두복	두복/NNP
두봉	두봉/NNP
두산	두산/NNP
두섭	두섭/NNP
두성	두성/NNP
두수	두수/NNP
두승	두승/NNP
두심	두심/NNP
두언	두언/NNP
두연	두연/NNP
두열	두열/NNP
두영	두영/NNP
두원	두원/NNP
두율	두율/NNP
두익	두익/NNP
두일	두일/NNP
두정	두정/NNP
두진	두진/NNP
두찬	두찬/NNP
두표	두표/NNP
두한	두한/NNP
두함	두함/NNP
두헌	두헌/NNP
두현	두현/NNP
두호	두호/NNP
두홍	두홍/NNP
두환	두환/NNP
두회	두회/NNP
두희	두희/NNP
득갑	득갑/NNP
득공	득공/NNP
득구	득구/NNP
득룡	득룡/NNP
득수	득수/NNP
득열	득열/NNP
득주	득주/NNP
득중	득중/NNP
득표	득표/NNP
득헌	득헌/NNP
득호	득호/NNP
득환	득환/NNP
득희	득희/NNP
등휘	등휘/NNP
락영	락영/NNP
락정	락정/NNP
락천	락천/NNP
락현	락현/NNP
락훈	락훈/NNP
래원	래원/NNP
록기	록기/NNP
록주	록주/NNP
록희	록희/NNP
류진	류진/NNP
류헌	류헌/NNP
만갑	만갑/NNP
만규	만규/NNP
만기	만기/NNP
만길	만길/NNP
만덕	만덕/NNP
만득	만득/NNP
만복	만복/NNP
만봉	만봉/NNP
만빈	만빈/NNP
만석	만석/NNP
만섭	만섭/NNP
만수	만수/NNP
만순	만순/NNP
만식	만식/NNP
만열	만열/NNP
만영	만영/NNP
만옥	만옥/NNP
만우	만우/NNP
만익	만익/NNP
만자	만자/NNP
만재	만재/NNP
만정	만정/NNP
만제	만제/NNP
만종	만종/NNP
만중	만중/NNP
만진	만진/NNP
만철	만철/NNP
만춘	만춘/NNP
만태	만태/NNP
만표	만표/NNP
만현	만현/NNP
만호	만호/NNP
만후	만후/NNP
만훈	만훈/NNP
만희	만희/NNP
말룡	말룡/NNP
말봉	말봉/NNP
말숙	말숙/NNP
말순	말순/NNP
말주	말주/NNP
말희	말희/NNP
맹규	맹규/NNP
맹순	맹순/NNP
맹우	맹우/NNP
면우	면우/NNP
면주	면주/NNP
면중	면중/NNP
면호	면호/NNP
명건	명건/NNP
명걸	명걸/NNP
명곤	명곤/NNP
명관	명관/NNP
명구	명구/NNP
명국	명국/NNP
명규	명규/NNP
명균	명균/NNP
명근	명근/NNP
명기	명기/NNP
명길	명길/NNP
명남	명남/NNP
명대	명대/NNP
명래	명래/NNP
명례	명례/NNP
명박	명박/NNP
명배	명배/NNP
명보	명보/NNP
명복	명복/NNP
명부	명부/NNP
명산	명산/NNP
명서	명서/NNP
명석	명석/NNP
명선	명선/NNP
명섭	명섭/NNP
명수	명수/NNP
명숙	명숙/NNP
명순	명순/NNP
명식	명식/NNP
명아	명아/NNP
명암	명암/NNP
명애	명애/NNP
명영	명영/NNP
명옥	명옥/NNP
명우	명우/NNP
명운	명운/NNP
명원	명원/NNP
명윤	명윤/NNP
명익	명익/NNP
명인	명인/NNP
명임	명임/NNP
명자	명자/NNP
명재	명재/NNP
명정	명정/NNP
명제	명제/NNP
명조	명조/NNP
명좌	명좌/NNP
명주	명주/NNP
명준	명준/NNP
명진	명진/NNP
명찬	명찬/NNP
명천	명천/NNP
명철	명철/NNP
명칠	명칠/NNP
명하	명하/NNP
명학	명학/NNP
명행	명행/NNP
명헌	명헌/NNP
명현	명현/NNP
명혜	명혜/NNP
명호	명호/NNP
명화	명화/NNP
명환	명환/NNP
명회	명회/NNP
명훈	명훈/NNP
명휘	명휘/NNP
명희	명희/NNP
모세	모세/NNP
목희	목희/NNP
몽구	몽구/NNP
몽규	몽규/NNP
몽룡	몽룡/NNP
몽윤	몽윤/NNP
몽주	몽주/NNP
몽준	몽준/NNP
몽학	몽학/NNP
몽헌	몽헌/NNP
무룡	무룡/NNP
무섭	무섭/NNP
무성	무성/NNP
무송	무송/NNP
무연	무연/NNP
무열	무열/NNP
무영	무영/NNP
무혁	무혁/NNP
무현	무현/NNP
무환	무환/NNP
문경	문경/NNP
문국	문국/NNP
문권	문권/NNP
문규	문규/NNP
문기	문기/NNP
문길	문길/NNP
문량	문량/NNP
문로	문로/NNP
문룡	문룡/NNP
문부	문부/NNP
문생	문생/NNP
문석	문석/NNP
문선	문선/NNP
문섭	문섭/NNP
문성	문성/NNP
문세	문세/NNP
문수	문수/NNP
문숙	문숙/NNP
문순	문순/NNP
문술	문술/NNP
문연	문연/NNP
문열	문열/NNP
문영	문영/NNP
문옥	문옥/NNP
문우	문우/NNP
문웅	문웅/NNP
문원	문원/NNP
문위	문위/NNP
문자	문자/NNP
문재	문재/NNP
문종	문종/NNP
문주	문주/NNP
문준	문준/NNP
문진	문진/NNP
문집	문집/NNP
문창	문창/NNP
문츄	문츄/NNP
문태	문태/NNP
문현	문현/NNP
문호	문호/NNP
문홍	문홍/NNP
문화	문화/NNP
문환	문환/NNP
문회	문회/NNP
문휴	문휴/NNP
문희	문희/NNP
미경	미경/NNP
미곤	미곤/NNP
미나	미나/NNP
미단	미단/NNP
미당	미당/NNP
미라	미라/NNP
미란	미란/NNP
미랑	미랑/NNP
미래	미래/NNP
미량	미량/NNP
미례	미례/NNP
미림	미림/NNP
미미	미미/NNP
미선	미선/NNP
미성	미성/NNP
미수	미수/NNP
미숙	미숙/NNP
미순	미순/NNP
미애	미애/NNP
미연	미연/NNP
미영	미영/NNP
미예	미예/NNP
미옥	미옥/NNP
미은	미은/NNP
미자	미자/NNP
미정	미정/NNP
미진	미진/NNP
미향	미향/NNP
미현	미현/NNP
미형	미형/NNP
미혜	미혜/NNP
미홍	미홍/NNP
미화	미화/NNP
미환	미환/NNP
미희	미희/NNP
민각	민각/NNP
민경	민경/NNP
민구	민구/NNP
민국	민국/NNP
민권	민권/NNP
민규	민규/NNP
민기	민기/NNP
민련	민련/NNP
민복	민복/NNP
민상	민상/NNP
민서	민서/NNP
민석	민석/NNP
민선	민선/NNP
민섭	민섭/NNP
민성	민성/NNP
민수	민수/NNP
민숙	민숙/NNP
민순	민순/NNP
민시	민시/NNP
민식	민식/NNP
민아	민아/NNP
민영	민영/NNP
민우	민우/NNP
민웅	민웅/NNP
민재	민재/NNP
민적	민적/NNP
민전	민전/NNP
민정	민정/NNP
민조	민조/NNP
민종	민종/NNP
민주	민주/NNP
민준	민준/NNP
민중	민중/NNP
민지	민지/NNP
민찬	민찬/NNP
민창	민창/NNP
민태	민태/NNP
민표	민표/NNP
민하	민하/NNP
민한	민한/NNP
민혁	민혁/NNP
민호	민호/NNP
민홍	민홍/NNP
민화	민화/NNP
민환	민환/NNP
민휘	민휘/NNP
민희	민희/NNP
방림	방림/NNP
방부	방부/NNP
방옥	방옥/NNP
방우	방우/NNP
방욱	방욱/NNP
방원	방원/NNP
방익	방익/NNP
방현	방현/NNP
방희	방희/NNP
배근	배근/NNP
배숙	배숙/NNP
배원	배원/NNP
배희	배희/NNP
백규	백규/NNP
백남	백남/NNP
백산	백산/NNP
백영	백영/NNP
백진	백진/NNP
백천	백천/NNP
백헌	백헌/NNP
백현	백현/NNP
백회	백회/NNP
번기	번기/NNP
번송	번송/NNP
범강	범강/NNP
범구	범구/NNP
범규	범규/NNP
범남	범남/NNP
범렬	범렬/NNP
범룡	범룡/NNP
범명	범명/NNP
범모	범모/NNP
범서	범서/NNP
범석	범석/NNP
범선	범선/NNP
범수	범수/NNP
범숙	범숙/NNP
범술	범술/NNP
범식	범식/NNP
범신	범신/NNP
범영	범영/NNP
범우	범우/NNP
범익	범익/NNP
범일	범일/NNP
범재	범재/NNP
범주	범주/NNP
범준	범준/NNP
범진	범진/NNP
범현	범현/NNP
범훈	범훈/NNP
범희	범희/NNP
변현	변현/NNP
병각	병각/NNP
병갑	병갑/NNP
병건	병건/NNP
병걸	병걸/NNP
병곤	병곤/NNP
병관	병관/NNP
병구	병구/NNP
병국	병국/NNP
병권	병권/NNP
병규	병규/NNP
병균	병균/NNP
병근	병근/NNP
병기	병기/NNP
병길	병길/NNP
병남	병남/NNP
병대	병대/NNP
병덕	병덕/NNP
병득	병득/NNP
병란	병란/NNP
병래	병래/NNP
병량	병량/NNP
병렬	병렬/NNP
병령	병령/NNP
병로	병로/NNP
병록	병록/NNP
병룡	병룡/NNP
병률	병률/NNP
병모	병모/NNP
병무	병무/NNP
병묵	병묵/NNP
병문	병문/NNP
병민	병민/NNP
병배	병배/NNP
병복	병복/NNP
병산	병산/NNP
병삼	병삼/NNP
병서	병서/NNP
병석	병석/NNP
병선	병선/NNP
병섭	병섭/NNP
병세	병세/NNP
병송	병송/NNP
병수	병수/NNP
병숙	병숙/NNP
병순	병순/NNP
병시	병시/NNP
병식	병식/NNP
병안	병안/NNP
병애	병애/NNP
병언	병언/NNP
병업	병업/NNP
병연	병연/NNP
병엽	병엽/NNP
병오	병오/NNP
병옥	병옥/NNP
병완	병완/NNP
병우	병우/NNP
병욱	병욱/NNP
병운	병운/NNP
병윤	병윤/NNP
병익	병익/NNP
병인	병인/NNP
병일	병일/NNP
병재	병재/NNP
병조	병조/NNP
병종	병종/NNP
병주	병주/NNP
병준	병준/NNP
병중	병중/NNP
병지	병지/NNP
병직	병직/NNP
병진	병진/NNP
병찬	병찬/NNP
병채	병채/NNP
병천	병천/NNP
병철	병철/NNP
병청	병청/NNP
병초	병초/NNP
병총	병총/NNP
병춘	병춘/NNP
병칠	병칠/NNP
병탁	병탁/NNP
병태	병태/NNP
병택	병택/NNP
병하	병하/NNP
병학	병학/NNP
병헌	병헌/NNP
병현	병현/NNP
병호	병호/NNP
병홍	병홍/NNP
병화	병화/NNP
병환	병환/NNP
병효	병효/NNP
병후	병후/NNP
병훈	병훈/NNP
병휴	병휴/NNP
병희	병희/NNP
보경	보경/NNP
보국	보국/NNP
보근	보근/NNP
보남	보남/NNP
보령	보령/NNP
보록	보록/NNP
보밀	보밀/NNP
보석	보석/NNP
보선	보선/NNP
보성	보성/NNP
보연	보연/NNP
보열	보열/NNP
보영	보영/NNP
보윤	보윤/NNP
보헌	보헌/NNP
보현	보현/NNP
보협	보협/NNP
보형	보형/NNP
보혜	보혜/NNP
보환	보환/NNP
보희	보희/NNP
복경	복경/NNP
복규	복규/NNP
복남	복남/NNP
복녀	복녀/NNP
복래	복래/NNP
복례	복례/NNP
복순	복순/NNP
복영	복영/NNP
복재	복재/NNP
복진	복진/NNP
복현	복현/NNP
복환	복환/NNP
복희	복희/NNP
봉건	봉건/NNP
봉곤	봉곤/NNP
봉구	봉구/NNP
봉국	봉국/NNP
봉권	봉권/NNP
봉규	봉규/NNP
봉균	봉균/NNP
봉근	봉근/NNP
봉기	봉기/NNP
봉길	봉길/NNP
봉녀	봉녀/NNP
봉대	봉대/NNP
봉덕	봉덕/NNP
봉득	봉득/NNP
봉란	봉란/NNP
봉래	봉래/NNP
봉렬	봉렬/NNP
봉룡	봉룡/NNP
봉루	봉루/NNP
봉률	봉률/NNP
봉모	봉모/NNP
봉문	봉문/NNP
봉민	봉민/NNP
봉삼	봉삼/NNP
봉상	봉상/NNP
봉서	봉서/NNP
봉석	봉석/NNP
봉선	봉선/NNP
봉성	봉성/NNP
봉수	봉수/NNP
봉숙	봉숙/NNP
봉순	봉순/NNP
봉식	봉식/NNP
봉암	봉암/NNP
봉양	봉양/NNP
봉영	봉영/NNP
봉옥	봉옥/NNP
봉우	봉우/NNP
봉욱	봉욱/NNP
봉운	봉운/NNP
봉인	봉인/NNP
봉일	봉일/NNP
봉자	봉자/NNP
봉조	봉조/NNP
봉주	봉주/NNP
봉준	봉준/NNP
봉진	봉진/NNP
봉집	봉집/NNP
봉창	봉창/NNP
봉철	봉철/NNP
봉춘	봉춘/NNP
봉태	봉태/NNP
봉택	봉택/NNP
봉향	봉향/NNP
봉헌	봉헌/NNP
봉호	봉호/NNP
봉환	봉환/NNP
봉회	봉회/NNP
봉희	봉희/NNP
부겸	부겸/NNP
부곤	부곤/NNP
부근	부근/NNP
부길	부길/NNP
부성	부성/NNP
부연	부연/NNP
부영	부영/NNP
부희	부희/NNP
분련	분련/NNP
분석	분석/NNP
분숙	분숙/NNP
분순	분순/NNP
분희	분희/NNP
불암	불암/NNP
사덕	사덕/NNP
사빈	사빈/NNP
사성	사성/NNP
사순	사순/NNP
삼득	삼득/NNP
삼례	삼례/NNP
삼룡	삼룡/NNP
삼석	삼석/NNP
삼섭	삼섭/NNP
삼수	삼수/NNP
삼숙	삼숙/NNP
삼승	삼승/NNP
삼식	삼식/NNP
삼암	삼암/NNP
삼열	삼열/NNP
삼영	삼영/NNP
삼우	삼우/NNP
삼웅	삼웅/NNP
삼육	삼육/NNP
삼윤	삼윤/NNP
삼재	삼재/NNP
삼주	삼주/NNP
삼진	삼진/NNP
삼태	삼태/NNP
삼환	삼환/NNP
삼훈	삼훈/NNP
상각	상각/NNP
상갑	상갑/NNP
상건	상건/NNP
상경	상경/NNP
상계	상계/NNP
상곤	상곤/NNP
상교	상교/NNP
상구	상구/NNP
상국	상국/NNP
상권	상권/NNP
상규	상규/NNP
상균	상균/NNP
상기	상기/NNP
상길	상길/NNP
상남	상남/NNP
상대	상대/NNP
상덕	상덕/NNP
상돈	상돈/NNP
상득	상득/NNP
상락	상락/NNP
상래	상래/NNP
상렬	상렬/NNP
상로	상로/NNP
상록	상록/NNP
상룡	상룡/NNP
상률	상률/NNP
상륭	상륭/NNP
상림	상림/NNP
상명	상명/NNP
상모	상모/NNP
상목	상목/NNP
상묵	상묵/NNP
상문	상문/NNP
상미	상미/NNP
상민	상민/NNP
상배	상배/NNP
상백	상백/NNP
상범	상범/NNP
상벽	상벽/NNP
상병	상병/NNP
상보	상보/NNP
상복	상복/NNP
상봉	상봉/NNP
상부	상부/NNP
상석	상석/NNP
상선	상선/NNP
상설	상설/NNP
상섭	상섭/NNP
상수	상수/NNP
상숙	상숙/NNP
상순	상순/NNP
상술	상술/NNP
상신	상신/NNP
상악	상악/NNP
상억	상억/NNP
상언	상언/NNP
상업	상업/NNP
상연	상연/NNP
상열	상열/NNP
상엽	상엽/NNP
상영	상영/NNP
상오	상오/NNP
상옥	상옥/NNP
상온	상온/NNP
상우	상우/NNP
상욱	상욱/NNP
상운	상운/NNP
상웅	상웅/NNP
상원	상원/NNP
상위	상위/NNP
상윤	상윤/NNP
상융	상융/NNP
상익	상익/NNP
상인	상인/NNP
상일	상일/NNP
상임	상임/NNP
상재	상재/NNP
상종	상종/NNP
상주	상주/NNP
상준	상준/NNP
상증	상증/NNP
상진	상진/NNP
상채	상채/NNP
상천	상천/NNP
상철	상철/NNP
상초	상초/NNP
상총	상총/NNP
상춘	상춘/NNP
상출	상출/NNP
상칠	상칠/NNP
상태	상태/NNP
상택	상택/NNP
상필	상필/NNP
상하	상하/NNP
상학	상학/NNP
상헌	상헌/NNP
상혁	상혁/NNP
상현	상현/NNP
상협	상협/NNP
상호	상호/NNP
상홍	상홍/NNP
상화	상화/NNP
상환	상환/NNP
상훈	상훈/NNP
상흔	상흔/NNP
상희	상희/NNP
새연	새연/NNP
생진	생진/NNP
생현	생현/NNP
서연	서연/NNP
서영	서영/NNP
서운	서운/NNP
서웅	서웅/NNP
서원	서원/NNP
서일	서일/NNP
서정	서정/NNP
서진	서진/NNP
서현	서현/NNP
서환	서환/NNP
서희	서희/NNP
석경	석경/NNP
석구	석구/NNP
석국	석국/NNP
석규	석규/NNP
석균	석균/NNP
석근	석근/NNP
석기	석기/NNP
석남	석남/NNP
석란	석란/NNP
석래	석래/NNP
석렬	석렬/NNP
석린	석린/NNP
석명	석명/NNP
석모	석모/NNP
석무	석무/NNP
석민	석민/NNP
석배	석배/NNP
석범	석범/NNP
석복	석복/NNP
석봉	석봉/NNP
석순	석순/NNP
석심	석심/NNP
석양	석양/NNP
석연	석연/NNP
석영	석영/NNP
석완	석완/NNP
석우	석우/NNP
석운	석운/NNP
석원	석원/NNP
석윤	석윤/NNP
석인	석인/NNP
석일	석일/NNP
석재	석재/NNP
석정	석정/NNP
석제	석제/NNP
석조	석조/NNP
석종	석종/NNP
석주	석주/NNP
석준	석준/NNP
석중	석중/NNP
석증	석증/NNP
석지	석지/NNP
석진	석진/NNP
석찬	석찬/NNP
석창	석창/NNP
석채	석채/NNP
석천	석천/NNP
석철	석철/NNP
석청	석청/NNP
석춘	석춘/NNP
석출	석출/NNP
석태	석태/NNP
석택	석택/NNP
석포	석포/NNP
석필	석필/NNP
석하	석하/NNP
석헌	석헌/NNP
석현	석현/NNP
석형	석형/NNP
석호	석호/NNP
석홍	석홍/NNP
석화	석화/NNP
석환	석환/NNP
석훈	석훈/NNP
석휘	석휘/NNP
석희	석희/NNP
선경	선경/NNP
선공	선공/NNP
선관	선관/NNP
선교	선교/NNP
선구	선구/NNP
선국	선국/NNP
선규	선규/NNP
선기	선기/NNP
선길	선길/NNP
선나	선나/NNP
선대	선대/NNP
선덕	선덕/NNP
선례	선례/NNP
선루	선루/NNP
선명	선명/NNP
선모	선모/NNP
선문	선문/NNP
선미	선미/NNP
선보	선보/NNP
선숙	선숙/NNP
선아	선아/NNP
선애	선애/NNP
선영	선영/NNP
선옥	선옥/NNP
선우	선우/NNP
선웅	선웅/NNP
선인	선인/NNP
선임	선임/NNP
선자	선자/NNP
선정	선정/NNP
선종	선종/NNP
선주	선주/NNP
선준	선준/NNP
선중	선중/NNP
선진	선진/NNP
선철	선철/NNP
선태	선태/NNP
선평	선평/NNP
선표	선표/NNP
선하	선하/NNP
선해	선해/NNP
선혁	선혁/NNP
선현	선현/NNP
선형	선형/NNP
선혜	선혜/NNP
선호	선호/NNP
선홍	선홍/NNP
선화	선화/NNP
선희	선희/NNP
설봉	설봉/NNP
설빈	설빈/NNP
설야	설야/NNP
설희	설희/NNP
성각	성각/NNP
성강	성강/NNP
성걸	성걸/NNP
성경	성경/NNP
성계	성계/NNP
성곤	성곤/NNP
성관	성관/NNP
성광	성광/NNP
성구	성구/NNP
성국	성국/NNP
성권	성권/NNP
성규	성규/NNP
성균	성균/NNP
성근	성근/NNP
성금	성금/NNP
성기	성기/NNP
성길	성길/NNP
성남	성남/NNP
성달	성달/NNP
성담	성담/NNP
성대	성대/NNP
성덕	성덕/NNP
성두	성두/NNP
성득	성득/NNP
성락	성락/NNP
성래	성래/NNP
성렬	성렬/NNP
성례	성례/NNP
성록	성록/NNP
성룡	성룡/NNP
성률	성률/NNP
성립	성립/NNP
성모	성모/NNP
성무	성무/NNP
성문	성문/NNP
성미	성미/NNP
성민	성민/NNP
성배	성배/NNP
성범	성범/NNP
성보	성보/NNP
성복	성복/NNP
성봉	성봉/NNP
성빈	성빈/NNP
성산	성산/NNP
성삼	성삼/NNP
성석	성석/NNP
성선	성선/NNP
성섭	성섭/NNP
성수	성수/NNP
성숙	성숙/NNP
성순	성순/NNP
성실	성실/NNP
성안	성안/NNP
성애	성애/NNP
성연	성연/NNP
성열	성열/NNP
성엽	성엽/NNP
성영	성영/NNP
성오	성오/NNP
성옥	성옥/NNP
성욱	성욱/NNP
성운	성운/NNP
성웅	성웅/NNP
성원	성원/NNP
성윤	성윤/NNP
성익	성익/NNP
성인	성인/NNP
성일	성일/NNP
성임	성임/NNP
성자	성자/NNP
성재	성재/NNP
성제	성제/NNP
성조	성조/NNP
성종	성종/NNP
성주	성주/NNP
성준	성준/NNP
성중	성중/NNP
성지	성지/NNP
성진	성진/NNP
성찬	성찬/NNP
성채	성채/NNP
성천	성천/NNP
성철	성철/NNP
성촌	성촌/NNP
성춘	성춘/NNP
성칠	성칠/NNP
성탁	성탁/NNP
성태	성태/NNP
성택	성택/NNP
성표	성표/NNP
성하	성하/NNP
성학	성학/NNP
성해	성해/NNP
성헌	성헌/NNP
성혁	성혁/NNP
성현	성현/NNP
성혜	성혜/NNP
성호	성호/NNP
성홍	성홍/NNP
성화	성화/NNP
성환	성환/NNP
성효	성효/NNP
성훈	성훈/NNP
성희	성희/NNP
세겸	세겸/NNP
세곤	세곤/NNP
세광	세광/NNP
세규	세규/NNP
세균	세균/NNP
세길	세길/NNP
세나	세나/NNP
세남	세남/NNP
세돌	세돌/NNP
세라	세라/NNP
세란	세란/NNP
세련	세련/NNP
세명	세명/NNP
세문	세문/NNP
세민	세민/NNP
세범	세범/NNP
세빈	세빈/NNP
세아	세아/NNP
세암	세암/NNP
세양	세양/NNP
세연	세연/NNP
세영	세영/NNP
세옥	세옥/NNP
세완	세완/NNP
세욱	세욱/NNP
세웅	세웅/NNP
세원	세원/NNP
세윤	세윤/NNP
세은	세은/NNP
세정	세정/NNP
세주	세주/NNP
세준	세준/NNP
세중	세중/NNP
세진	세진/NNP
세창	세창/NNP
세택	세택/NNP
세필	세필/NNP
세헌	세헌/NNP
세혁	세혁/NNP
세현	세현/NNP
세형	세형/NNP
세화	세화/NNP
세환	세환/NNP
세훈	세훈/NNP
세희	세희/NNP
소라	소라/NNP
소령	소령/NNP
소례	소례/NNP
소룡	소룡/NNP
소림	소림/NNP
소미	소미/NNP
소민	소민/NNP
소산	소산/NNP
소선	소선/NNP
소성	소성/NNP
소앙	소앙/NNP
소연	소연/NNP
소영	소영/NNP
소운	소운/NNP
소원	소원/NNP
소월	소월/NNP
소익	소익/NNP
소전	소전/NNP
소정	소정/NNP
소진	소진/NNP
소천	소천/NNP
소혁	소혁/NNP
소현	소현/NNP
소형	소형/NNP
소혜	소혜/NNP
소희	소희/NNP
손문	손문/NNP
손열	손열/NNP
송강	송강/NNP
송규	송규/NNP
송무	송무/NNP
송미	송미/NNP
송민	송민/NNP
송운	송운/NNP
송자	송자/NNP
송죽	송죽/NNP
송준	송준/NNP
송학	송학/NNP
송화	송화/NNP
송희	송희/NNP
수경	수경/NNP
수곤	수곤/NNP
수관	수관/NNP
수광	수광/NNP
수근	수근/NNP
수길	수길/NNP
수남	수남/NNP
수녕	수녕/NNP
수돌	수돌/NNP
수련	수련/NNP
수로	수로/NNP
수룡	수룡/NNP
수림	수림/NNP
수미	수미/NNP
수민	수민/NNP
수범	수범/NNP
수봉	수봉/NNP
수빈	수빈/NNP
수아	수아/NNP
수연	수연/NNP
수영	수영/NNP
수옥	수옥/NNP
수윤	수윤/NNP
수일	수일/NNP
수임	수임/NNP
수자	수자/NNP
수장	수장/NNP
수재	수재/NNP
수전	수전/NNP
수정	수정/NNP
수종	수종/NNP
수지	수지/NNP
수진	수진/NNP
수찬	수찬/NNP
수창	수창/NNP
수천	수천/NNP
수철	수철/NNP
수충	수충/NNP
수태	수태/NNP
수택	수택/NNP
수행	수행/NNP
수헌	수헌/NNP
수혁	수혁/NNP
수현	수현/NNP
수혜	수혜/NNP
수호	수호/NNP
수화	수화/NNP
수환	수환/NNP
수훈	수훈/NNP
수희	수희/NNP
숙경	숙경/NNP
숙란	숙란/NNP
숙례	숙례/NNP
숙선	숙선/NNP
숙영	숙영/NNP
숙인	숙인/NNP
숙자	숙자/NNP
숙정	숙정/NNP
숙주	숙주/NNP
숙진	숙진/NNP
숙현	숙현/NNP
숙희	숙희/NNP
순각	순각/NNP
순관	순관/NNP
순구	순구/NNP
순권	순권/NNP
순규	순규/NNP
순금	순금/NNP
순기	순기/NNP
순길	순길/NNP
순남	순남/NNP
순녀	순녀/NNP
순달	순달/NNP
순덕	순덕/NNP
순득	순득/NNP
순래	순래/NNP
순령	순령/NNP
순례	순례/NNP
순명	순명/NNP
순모	순모/NNP
순목	순목/NNP
순배	순배/NNP
순범	순범/NNP
순복	순복/NNP
순분	순분/NNP
순빈	순빈/NNP
순상	순상/NNP
순선	순선/NNP
순섭	순섭/NNP
순성	순성/NNP
순승	순승/NNP
순신	순신/NNP
순심	순심/NNP
순애	순애/NNP
순양	순양/NNP
순억	순억/NNP
순연	순연/NNP
순열	순열/NNP
순엽	순엽/NNP
순영	순영/NNP
순오	순오/NNP
순옥	순옥/NNP
순우	순우/NNP
순욱	순욱/NNP
순원	순원/NNP
순응	순응/NNP
순인	순인/NNP
순일	순일/NNP
순임	순임/NNP
순자	순자/NNP
순재	순재/NNP
순정	순정/NNP
순제	순제/NNP
순조	순조/NNP
순지	순지/NNP
순채	순채/NNP
순천	순천/NNP
순철	순철/NNP
순태	순태/NNP
순택	순택/NNP
순행	순행/NNP
순현	순현/NNP
순협	순협/NNP
순형	순형/NNP
순혜	순혜/NNP
순호	순호/NNP
순홍	순홍/NNP
순화	순화/NNP
순환	순환/NNP
순효	순효/NNP
순흥	순흥/NNP
순희	순희/NNP
숭겸	숭겸/NNP
숭녕	숭녕/NNP
숭덕	숭덕/NNP
숭실	숭실/NNP
숭인	숭인/NNP
숭일	숭일/NNP
승각	승각/NNP
승갑	승갑/NNP
승겸	승겸/NNP
승경	승경/NNP
승곤	승곤/NNP
승교	승교/NNP
승구	승구/NNP
승국	승국/NNP
승권	승권/NNP
승규	승규/NNP
승균	승균/NNP
승근	승근/NNP
승기	승기/NNP
승길	승길/NNP
승남	승남/NNP
승녕	승녕/NNP
승노	승노/NNP
승대	승대/NNP
승덕	승덕/NNP
승련	승련/NNP
승렬	승렬/NNP
승로	승로/NNP
승록	승록/NNP
승룡	승룡/NNP
승률	승률/NNP
승모	승모/NNP
승목	승목/NNP
승미	승미/NNP
승민	승민/NNP
승배	승배/NNP
승백	승백/NNP
승범	승범/NNP
승벽	승벽/NNP
승복	승복/NNP
승비	승비/NNP
승빈	승빈/NNP
승서	승서/NNP
승수	승수/NNP
승식	승식/NNP
승안	승안/NNP
승애	승애/NNP
승언	승언/NNP
승업	승업/NNP
승연	승연/NNP
승열	승열/NNP
승엽	승엽/NNP
승영	승영/NNP
승오	승오/NNP
승옥	승옥/NNP
승완	승완/NNP
승우	승우/NNP
승욱	승욱/NNP
승원	승원/NNP
승유	승유/NNP
승윤	승윤/NNP
승일	승일/NNP
승자	승자/NNP
승재	승재/NNP
승전	승전/NNP
승정	승정/NNP
승조	승조/NNP
승주	승주/NNP
승준	승준/NNP
승지	승지/NNP
승직	승직/NNP
승진	승진/NNP
승집	승집/NNP
승찬	승찬/NNP
승창	승창/NNP
승천	승천/NNP
승철	승철/NNP
승태	승태/NNP
승택	승택/NNP
승포	승포/NNP
승표	승표/NNP
승필	승필/NNP
승하	승하/NNP
승학	승학/NNP
승한	승한/NNP
승헌	승헌/NNP
승혁	승혁/NNP
승현	승현/NNP
승혜	승혜/NNP
승호	승호/NNP
승홍	승홍/NNP
승화	승화/NNP
승환	승환/NNP
승효	승효/NNP
승훈	승훈/NNP
승휘	승휘/NNP
승휴	승휴/NNP
승희	승희/NNP
시건	시건/NNP
시광	시광/NNP
시교	시교/NNP
시권	시권/NNP
시균	시균/NNP
시내	시내/NNP
시덕	시덕/NNP
시룡	시룡/NNP
시명	시명/NNP
시백	시백/NNP
시아	시아/NNP
시애	시애/NNP
시언	시언/NNP
시열	시열/NNP
시영	시영/NNP
시온	시온/NNP
시우	시우/NNP
시운	시운/NNP
시재	시재/NNP
시정	시정/NNP
시준	시준/NNP
시중	시중/NNP
시진	시진/NNP
시창	시창/NNP
시채	시채/NNP
시천	시천/NNP
시철	시철/NNP
시춘	시춘/NNP
시혁	시혁/NNP
시현	시현/NNP
시형	시형/NNP
시화	시화/NNP
시환	시환/NNP
시회	시회/NNP
신구	신구/NNP
신권	신권/NNP
신규	신규/NNP
신길	신길/NNP
신달	신달/NNP
신대	신대/NNP
신덕	신덕/NNP
신력	신력/NNP
신령	신령/NNP
신모	신모/NNP
신묵	신묵/NNP
신범	신범/NNP
신생	신생/NNP
신석	신석/NNP
신숙	신숙/NNP
신애	신애/NNP
신언	신언/NNP
신영	신영/NNP
신옥	신옥/NNP
신웅	신웅/NNP
신일	신일/NNP
신재	신재/NNP
신정	신정/NNP
신종	신종/NNP
신표	신표/NNP
신필	신필/NNP
신헌	신헌/NNP
신혁	신혁/NNP
신형	신형/NNP
신혜	신혜/NNP
아라	아라/NNP
아름	아름/NNP
아영	아영/NNP
아린	아린/NNP
안국	안국/NNP
안나	안나/NNP
안진	안진/NNP
애경	애경/NNP
애란	애란/NNP
애령	애령/NNP
애선	애선/NNP
애숙	애숙/NNP
애순	애순/NNP
애영	애영/NNP
애자	애자/NNP
애정	애정/NNP
애희	애희/NNP
양건	양건/NNP
양석	양석/NNP
양섭	양섭/NNP
양성	양성/NNP
양수	양수/NNP
양숙	양숙/NNP
양순	양순/NNP
양완	양완/NNP
양우	양우/NNP
양원	양원/NNP
양일	양일/NNP
양임	양임/NNP
양중	양중/NNP
양천	양천/NNP
양필	양필/NNP
양하	양하/NNP
양항	양항/NNP
양현	양현/NNP
양호	양호/NNP
양희	양희/NNP
억균	억균/NNP
억현	억현/NNP
언경	언경/NNP
언년	언년/NNP
언석	언석/NNP
언섭	언섭/NNP
언수	언수/NNP
언영	언영/NNP
언오	언오/NNP
언위	언위/NNP
언종	언종/NNP
언주	언주/NNP
언진	언진/NNP
언호	언호/NNP
언회	언회/NNP
언훈	언훈/NNP
여규	여규/NNP
여균	여균/NNP
여선	여선/NNP
여숙	여숙/NNP
여옥	여옥/NNP
여운	여운/NNP
여익	여익/NNP
여정	여정/NNP
여준	여준/NNP
여진	여진/NNP
여휘	여휘/NNP
연걸	연걸/NNP
연경	연경/NNP
연광	연광/NNP
연규	연규/NNP
연란	연란/NNP
연명	연명/NNP
연목	연목/NNP
연미	연미/NNP
연배	연배/NNP
연석	연석/NNP
연선	연선/NNP
연성	연성/NNP
연수	연수/NNP
연숙	연숙/NNP
연순	연순/NNP
연승	연승/NNP
연실	연실/NNP
연심	연심/NNP
연아	연아/NNP
연오	연오/NNP
연옥	연옥/NNP
연완	연완/NNP
연우	연우/NNP
연욱	연욱/NNP
연원	연원/NNP
연재	연재/NNP
연정	연정/NNP
연제	연제/NNP
연종	연종/NNP
연주	연주/NNP
연지	연지/NNP
연진	연진/NNP
연창	연창/NNP
연철	연철/NNP
연총	연총/NNP
연태	연태/NNP
연택	연택/NNP
연향	연향/NNP
연현	연현/NNP
연호	연호/NNP
연홍	연홍/NNP
연화	연화/NNP
연환	연환/NNP
연회	연회/NNP
연흠	연흠/NNP
연희	연희/NNP
열곤	열곤/NNP
열규	열규/NNP
열모	열모/NNP
열섭	열섭/NNP
열수	열수/NNP
염철	염철/NNP
영각	영각/NNP
영건	영건/NNP
영걸	영걸/NNP
영결	영결/NNP
영경	영경/NNP
영곤	영곤/NNP
영관	영관/NNP
영광	영광/NNP
영교	영교/NNP
영구	영구/NNP
영국	영국/NNP
영권	영권/NNP
영규	영규/NNP
영균	영균/NNP
영근	영근/NNP
영금	영금/NNP
영기	영기/NNP
영길	영길/NNP
영나	영나/NNP
영남	영남/NNP
영내	영내/NNP
영노	영노/NNP
영달	영달/NNP
영대	영대/NNP
영덕	영덕/NNP
영두	영두/NNP
영득	영득/NNP
영락	영락/NNP
영란	영란/NNP
영랑	영랑/NNP
영래	영래/NNP
영렬	영렬/NNP
영례	영례/NNP
영록	영록/NNP
영롱	영롱/NNP
영룡	영룡/NNP
영률	영률/NNP
영림	영림/NNP
영립	영립/NNP
영명	영명/NNP
영모	영모/NNP
영목	영목/NNP
영무	영무/NNP
영묵	영묵/NNP
영문	영문/NNP
영미	영미/NNP
영민	영민/NNP
영방	영방/NNP
영배	영배/NNP
영범	영범/NNP
영보	영보/NNP
영복	영복/NNP
영봉	영봉/NNP
영부	영부/NNP
영분	영분/NNP
영빈	영빈/NNP
영삼	영삼/NNP
영상	영상/NNP
영서	영서/NNP
영석	영석/NNP
영선	영선/NNP
영설	영설/NNP
영섭	영섭/NNP
영성	영성/NNP
영세	영세/NNP
영소	영소/NNP
영수	영수/NNP
영숙	영숙/NNP
영순	영순/NNP
영술	영술/NNP
영승	영승/NNP
영신	영신/NNP
영실	영실/NNP
영아	영아/NNP
영안	영안/NNP
영애	영애/NNP
영연	영연/NNP
영오	영오/NNP
영옥	영옥/NNP
영완	영완/NNP
영우	영우/NNP
영욱	영욱/NNP
영운	영운/NNP
영웅	영웅/NNP
영원	영원/NNP
영윤	영윤/NNP
영익	영익/NNP
영인	영인/NNP
영일	영일/NNP
영임	영임/NNP
영자	영자/NNP
영작	영작/NNP
영재	영재/NNP
영전	영전/NNP
영정	영정/NNP
영제	영제/NNP
영조	영조/NNP
영종	영종/NNP
영주	영주/NNP
영준	영준/NNP
영중	영중/NNP
영증	영증/NNP
영지	영지/NNP
영직	영직/NNP
영진	영진/NNP
영찬	영찬/NNP
영창	영창/NNP
영채	영채/NNP
영천	영천/NNP
영철	영철/NNP
영초	영초/NNP
영춘	영춘/NNP
영출	영출/NNP
영탁	영탁/NNP
영태	영태/NNP
영택	영택/NNP
영평	영평/NNP
영표	영표/NNP
영필	영필/NNP
영하	영하/NNP
영학	영학/NNP
영한	영한/NNP
영해	영해/NNP
영헌	영헌/NNP
영현	영현/NNP
영혜	영혜/NNP
영호	영호/NNP
영홍	영홍/NNP
영화	영화/NNP
영환	영환/NNP
영황	영황/NNP
영효	영효/NNP
영후	영후/NNP
영훈	영훈/NNP
영희	영희/NNP
예경	예경/NNP
예균	예균/NNP
예나	예나/NNP
예령	예령/NNP
예문	예문/NNP
예봉	예봉/NNP
예서	예서/NNP
예성	예성/NNP
예슬	예슬/NNP
예심	예심/NNP
예원	예원/NNP
예진	예진/NNP
예철	예철/NNP
예총	예총/NNP
예현	예현/NNP
오규	오규/NNP
오근	오근/NNP
오덕	오덕/NNP
오병	오병/NNP
오상	오상/NNP
오성	오성/NNP
오승	오승/NNP
오식	오식/NNP
오연	오연/NNP
오영	오영/NNP
오일	오일/NNP
오재	오재/NNP
오중	오중/NNP
오철	오철/NNP
오현	오현/NNP
오환	오환/NNP
오희	오희/NNP
옥경	옥경/NNP
옥균	옥균/NNP
옥금	옥금/NNP
옥길	옥길/NNP
옥두	옥두/NNP
옥란	옥란/NNP
옥련	옥련/NNP
옥렬	옥렬/NNP
옥륜	옥륜/NNP
옥미	옥미/NNP
옥보	옥보/NNP
옥분	옥분/NNP
옥빈	옥빈/NNP
옥산	옥산/NNP
옥상	옥상/NNP
옥선	옥선/NNP
옥성	옥성/NNP
옥수	옥수/NNP
옥숙	옥숙/NNP
옥순	옥순/NNP
옥연	옥연/NNP
옥영	옥영/NNP
옥임	옥임/NNP
옥자	옥자/NNP
옥제	옥제/NNP
옥조	옥조/NNP
옥주	옥주/NNP
옥진	옥진/NNP
옥현	옥현/NNP
옥화	옥화/NNP
옥희	옥희/NNP
온기	온기/NNP
온화	온화/NNP
완구	완구/NNP
완규	완규/NNP
완기	완기/NNP
완길	완길/NNP
완묵	완묵/NNP
완배	완배/NNP
완상	완상/NNP
완서	완서/NNP
완선	완선/NNP
완세	완세/NNP
완수	완수/NNP
완숙	완숙/NNP
완순	완순/NNP
완식	완식/NNP
완영	완영/NNP
완우	완우/NNP
완일	완일/NNP
완주	완주/NNP
완진	완진/NNP
완철	완철/NNP
완하	완하/NNP
완호	완호/NNP
완희	완희/NNP
왈순	왈순/NNP
왈종	왈종/NNP
왕국	왕국/NNP
왕기	왕기/NNP
왕대	왕대/NNP
왕령	왕령/NNP
왕모	왕모/NNP
왕산	왕산/NNP
왕종	왕종/NNP
왕직	왕직/NNP
외건	외건/NNP
외수	외수/NNP
외연	외연/NNP
요섭	요섭/NNP
요셉	요셉/NNP
요안	요안/NNP
요원	요원/NNP
요한	요한/NNP
용갑	용갑/NNP
용걸	용걸/NNP
용경	용경/NNP
용곤	용곤/NNP
용관	용관/NNP
용교	용교/NNP
용구	용구/NNP
용국	용국/NNP
용권	용권/NNP
용규	용규/NNP
용균	용균/NNP
용근	용근/NNP
용기	용기/NNP
용길	용길/NNP
용남	용남/NNP
용녀	용녀/NNP
용노	용노/NNP
용대	용대/NNP
용덕	용덕/NNP
용락	용락/NNP
용래	용래/NNP
용로	용로/NNP
용린	용린/NNP
용림	용림/NNP
용묵	용묵/NNP
용문	용문/NNP
용민	용민/NNP
용배	용배/NNP
용범	용범/NNP
용복	용복/NNP
용부	용부/NNP
용산	용산/NNP
용삼	용삼/NNP
용상	용상/NNP
용석	용석/NNP
용선	용선/NNP
용섭	용섭/NNP
용성	용성/NNP
용세	용세/NNP
용수	용수/NNP
용숙	용숙/NNP
용순	용순/NNP
용악	용악/NNP
용연	용연/NNP
용오	용오/NNP
용옥	용옥/NNP
용완	용완/NNP
용우	용우/NNP
용욱	용욱/NNP
용운	용운/NNP
용웅	용웅/NNP
용원	용원/NNP
용윤	용윤/NNP
용익	용익/NNP
용재	용재/NNP
용제	용제/NNP
용주	용주/NNP
용준	용준/NNP
용직	용직/NNP
용진	용진/NNP
용찬	용찬/NNP
용채	용채/NNP
용천	용천/NNP
용철	용철/NNP
용탁	용탁/NNP
용태	용태/NNP
용택	용택/NNP
용팔	용팔/NNP
용필	용필/NNP
용하	용하/NNP
용학	용학/NNP
용헌	용헌/NNP
용혁	용혁/NNP
용현	용현/NNP
용호	용호/NNP
용화	용화/NNP
용환	용환/NNP
용후	용후/NNP
용훈	용훈/NNP
용희	용희/NNP
우건	우건/NNP
우걸	우걸/NNP
우겸	우겸/NNP
우규	우규/NNP
우근	우근/NNP
우당	우당/NNP
우덕	우덕/NNP
우람	우람/NNP
우봉	우봉/NNP
우석	우석/NNP
우섭	우섭/NNP
우성	우성/NNP
우송	우송/NNP
우숙	우숙/NNP
우순	우순/NNP
우식	우식/NNP
우여	우여/NNP
우열	우열/NNP
우영	우영/NNP
우익	우익/NNP
우일	우일/NNP
우재	우재/NNP
우종	우종/NNP
우중	우중/NNP
우진	우진/NNP
우찬	우찬/NNP
우창	우창/NNP
우탁	우탁/NNP
우택	우택/NNP
우혁	우혁/NNP
우현	우현/NNP
우형	우형/NNP
우혜	우혜/NNP
우호	우호/NNP
우화	우화/NNP
우환	우환/NNP
우희	우희/NNP
욱경	욱경/NNP
욱상	욱상/NNP
욱순	욱순/NNP
욱준	욱준/NNP
욱진	욱진/NNP
욱철	욱철/NNP
욱현	욱현/NNP
운각	운각/NNP
운경	운경/NNP
운광	운광/NNP
운구	운구/NNP
운기	운기/NNP
운덕	운덕/NNP
운룡	운룡/NNP
운보	운보/NNP
운서	운서/NNP
운선	운선/NNP
운성	운성/NNP
운열	운열/NNP
운영	운영/NNP
운재	운재/NNP
운조	운조/NNP
운주	운주/NNP
운천	운천/NNP
운태	운태/NNP
운택	운택/NNP
운필	운필/NNP
운학	운학/NNP
운현	운현/NNP
운형	운형/NNP
운희	운희/NNP
원갑	원갑/NNP
원교	원교/NNP
원구	원구/NNP
원국	원국/NNP
원규	원규/NNP
원균	원균/NNP
원극	원극/NNP
원근	원근/NNP
원길	원길/NNP
원두	원두/NNP
원득	원득/NNP
원렬	원렬/NNP
원로	원로/NNP
원룡	원룡/NNP
원명	원명/NNP
원모	원모/NNP
원묵	원묵/NNP
원민	원민/NNP
원방	원방/NNP
원배	원배/NNP
원백	원백/NNP
원범	원범/NNP
원복	원복/NNP
원본	원본/NNP
원봉	원봉/NNP
원북	원북/NNP
원석	원석/NNP
원선	원선/NNP
원섭	원섭/NNP
원성	원성/NNP
원수	원수/NNP
원숙	원숙/NNP
원순	원순/NNP
원식	원식/NNP
원실	원실/NNP
원열	원열/NNP
원엽	원엽/NNP
원영	원영/NNP
원우	원우/NNP
원욱	원욱/NNP
원웅	원웅/NNP
원익	원익/NNP
원일	원일/NNP
원재	원재/NNP
원정	원정/NNP
원제	원제/NNP
원종	원종/NNP
원준	원준/NNP
원중	원중/NNP
원진	원진/NNP
원창	원창/NNP
원철	원철/NNP
원탁	원탁/NNP
원태	원태/NNP
원택	원택/NNP
원표	원표/NNP
원필	원필/NNP
원하	원하/NNP
원현	원현/NNP
원형	원형/NNP
원혜	원혜/NNP
원호	원호/NNP
원홍	원홍/NNP
원화	원화/NNP
원환	원환/NNP
원희	원희/NNP
위정	위정/NNP
웅재	웅재/NNP
유경	유경/NNP
유곤	유곤/NNP
유권	유권/NNP
유근	유근/NNP
유기	유기/NNP
유남	유남/NNP
유덕	유덕/NNP
유란	유란/NNP
유림	유림/NNP
유문	유문/NNP
유미	유미/NNP
유민	유민/NNP
유방	유방/NNP
유복	유복/NNP
유상	유상/NNP
유석	유석/NNP
유선	유선/NNP
유섭	유섭/NNP
유성	유성/NNP
유순	유순/NNP
유신	유신/NNP
유영	유영/NNP
유오	유오/NNP
유원	유원/NNP
유위	유위/NNP
유윤	유윤/NNP
유일	유일/NNP
유자	유자/NNP
유전	유전/NNP
유정	유정/NNP
유진	유진/NNP
유찬	유찬/NNP
유천	유천/NNP
유태	유태/NNP
유택	유택/NNP
유한	유한/NNP
유현	유현/NNP
유형	유형/NNP
유홍	유홍/NNP
유환	유환/NNP
유후	유후/NNP
유희	유희/NNP
윤건	윤건/NNP
윤경	윤경/NNP
윤광	윤광/NNP
윤구	윤구/NNP
윤규	윤규/NNP
윤근	윤근/NNP
윤기	윤기/NNP
윤길	윤길/NNP
윤대	윤대/NNP
윤덕	윤덕/NNP
윤라	윤라/NNP
윤모	윤모/NNP
윤문	윤문/NNP
윤미	윤미/NNP
윤범	윤범/NNP
윤복	윤복/NNP
윤상	윤상/NNP
윤석	윤석/NNP
윤선	윤선/NNP
윤성	윤성/NNP
윤수	윤수/NNP
윤숙	윤숙/NNP
윤순	윤순/NNP
윤식	윤식/NNP
윤신	윤신/NNP
윤심	윤심/NNP
윤아	윤아/NNP
윤애	윤애/NNP
윤영	윤영/NNP
윤옥	윤옥/NNP
윤우	윤우/NNP
윤원	윤원/NNP
윤익	윤익/NNP
윤자	윤자/NNP
윤재	윤재/NNP
윤정	윤정/NNP
윤제	윤제/NNP
윤조	윤조/NNP
윤종	윤종/NNP
윤주	윤주/NNP
윤지	윤지/NNP
윤진	윤진/NNP
윤창	윤창/NNP
윤철	윤철/NNP
윤칠	윤칠/NNP
윤택	윤택/NNP
윤텍	윤텍/NNP
윤필	윤필/NNP
윤하	윤하/NNP
윤학	윤학/NNP
윤현	윤현/NNP
윤형	윤형/NNP
윤호	윤호/NNP
윤홍	윤홍/NNP
윤화	윤화/NNP
윤환	윤환/NNP
윤회	윤회/NNP
윤희	윤희/NNP
율미	율미/NNP
융남	융남/NNP
융일	융일/NNP
융조	융조/NNP
융중	융중/NNP
은결	은결/NNP
은경	은경/NNP
은곤	은곤/NNP
은관	은관/NNP
은교	은교/NNP
은구	은구/NNP
은국	은국/NNP
은규	은규/NNP
은기	은기/NNP
은길	은길/NNP
은령	은령/NNP
은미	은미/NNP
은배	은배/NNP
은범	은범/NNP
은복	은복/NNP
은산	은산/NNP
은상	은상/NNP
은서	은서/NNP
은석	은석/NNP
은선	은선/NNP
은섭	은섭/NNP
은성	은성/NNP
은수	은수/NNP
은숙	은숙/NNP
은순	은순/NNP
은실	은실/NNP
은심	은심/NNP
은아	은아/NNP
은애	은애/NNP
은엽	은엽/NNP
은영	은영/NNP
은옥	은옥/NNP
은우	은우/NNP
은일	은일/NNP
은임	은임/NNP
은자	은자/NNP
은정	은정/NNP
은주	은주/NNP
은준	은준/NNP
은중	은중/NNP
은지	은지/NNP
은진	은진/NNP
은찬	은찬/NNP
은철	은철/NNP
은태	은태/NNP
은택	은택/NNP
은파	은파/NNP
은표	은표/NNP
은하	은하/NNP
은형	은형/NNP
은혜	은혜/NNP
은호	은호/NNP
은화	은화/NNP
은환	은환/NNP
은희	은희/NNP
응규	응규/NNP
응남	응남/NNP
응래	응래/NNP
응로	응로/NNP
응모	응모/NNP
응문	응문/NNP
응민	응민/NNP
응백	응백/NNP
응범	응범/NNP
응부	응부/NNP
응상	응상/NNP
응서	응서/NNP
응석	응석/NNP
응선	응선/NNP
응섭	응섭/NNP
응수	응수/NNP
응승	응승/NNP
응우	응우/NNP
응인	응인/NNP
응조	응조/NNP
응주	응주/NNP
응준	응준/NNP
응지	응지/NNP
응천	응천/NNP
응철	응철/NNP
응택	응택/NNP
응표	응표/NNP
응하	응하/NNP
응현	응현/NNP
응호	응호/NNP
의갑	의갑/NNP
의겸	의겸/NNP
의경	의경/NNP
의곤	의곤/NNP
의관	의관/NNP
의근	의근/NNP
의길	의길/NNP
의달	의달/NNP
의당	의당/NNP
의돈	의돈/NNP
의민	의민/NNP
의방	의방/NNP
의범	의범/NNP
의복	의복/NNP
의부	의부/NNP
의산	의산/NNP
의상	의상/NNP
의석	의석/NNP
의성	의성/NNP
의송	의송/NNP
의수	의수/NNP
의순	의순/NNP
의술	의술/NNP
의연	의연/NNP
의영	의영/NNP
의익	의익/NNP
의일	의일/NNP
의현	의현/NNP
이영	이영/NNP
이옥	이옥/NNP
이윤	이윤/NNP
이정	이정/NNP
이종	이종/NNP
이주	이주/NNP
이준	이준/NNP
이한	이한/NNP
이헌	이헌/NNP
이혁	이혁/NNP
이현	이현/NNP
익겸	익겸/NNP
익선	익선/NNP
익성	익성/NNP
익수	익수/NNP
익순	익순/NNP
익재	익재/NNP
익점	익점/NNP
익제	익제/NNP
익종	익종/NNP
익준	익준/NNP
익진	익진/NNP
익태	익태/NNP
익택	익택/NNP
익표	익표/NNP
익현	익현/NNP
익환	익환/NNP
익회	익회/NNP
익훈	익훈/NNP
인겸	인겸/NNP
인경	인경/NNP
인곤	인곤/NNP
인교	인교/NNP
인구	인구/NNP
인국	인국/NNP
인권	인권/NNP
인궤	인궤/NNP
인규	인규/NNP
인균	인균/NNP
인근	인근/NNP
인남	인남/NNP
인낭	인낭/NNP
인노	인노/NNP
인달	인달/NNP
인대	인대/NNP
인덕	인덕/NNP
인두	인두/NNP
인례	인례/NNP
인로	인로/NNP
인모	인모/NNP
인문	인문/NNP
인배	인배/NNP
인범	인범/NNP
인병	인병/NNP
인보	인보/NNP
인비	인비/NNP
인상	인상/NNP
인서	인서/NNP
인석	인석/NNP
인선	인선/NNP
인섭	인섭/NNP
인성	인성/NNP
인수	인수/NNP
인숙	인숙/NNP
인순	인순/NNP
인승	인승/NNP
인실	인실/NNP
인안	인안/NNP
인애	인애/NNP
인열	인열/NNP
인엽	인엽/NNP
인영	인영/NNP
인옥	인옥/NNP
인완	인완/NNP
인우	인우/NNP
인욱	인욱/NNP
인웅	인웅/NNP
인원	인원/NNP
인자	인자/NNP
인재	인재/NNP
인전	인전/NNP
인정	인정/NNP
인제	인제/NNP
인종	인종/NNP
인준	인준/NNP
인직	인직/NNP
인진	인진/NNP
인찬	인찬/NNP
인천	인천/NNP
인철	인철/NNP
인초	인초/NNP
인촌	인촌/NNP
인탁	인탁/NNP
인태	인태/NNP
인택	인택/NNP
인표	인표/NNP
인하	인하/NNP
인학	인학/NNP
인한	인한/NNP
인행	인행/NNP
인향	인향/NNP
인혁	인혁/NNP
인현	인현/NNP
인형	인형/NNP
인혜	인혜/NNP
인호	인호/NNP
인홍	인홍/NNP
인화	인화/NNP
인환	인환/NNP
인회	인회/NNP
인후	인후/NNP
인훈	인훈/NNP
인휘	인휘/NNP
인희	인희/NNP
일겸	일겸/NNP
일곤	일곤/NNP
일국	일국/NNP
일권	일권/NNP
일규	일규/NNP
일근	일근/NNP
일기	일기/NNP
일남	일남/NNP
일룡	일룡/NNP
일륜	일륜/NNP
일무	일무/NNP
일묵	일묵/NNP
일미	일미/NNP
일범	일범/NNP
일상	일상/NNP
일서	일서/NNP
일석	일석/NNP
일선	일선/NNP
일성	일성/NNP
일수	일수/NNP
일숙	일숙/NNP
일순	일순/NNP
일숭	일숭/NNP
일연	일연/NNP
일엽	일엽/NNP
일영	일영/NNP
일우	일우/NNP
일웅	일웅/NNP
일재	일재/NNP
일준	일준/NNP
일채	일채/NNP
일천	일천/NNP
일철	일철/NNP
일평	일평/NNP
일표	일표/NNP
일하	일하/NNP
일헌	일헌/NNP
일현	일현/NNP
일호	일호/NNP
일홍	일홍/NNP
일화	일화/NNP
일환	일환/NNP
일훈	일훈/NNP
일희	일희/NNP
임근	임근/NNP
임생	임생/NNP
임선	임선/NNP
임수	임수/NNP
임순	임순/NNP
임연	임연/NNP
임택	임택/NNP
자강	자강/NNP
자광	자광/NNP
자룡	자룡/NNP
자영	자영/NNP
자옥	자옥/NNP
자헌	자헌/NNP
자혜	자혜/NNP
자효	자효/NNP
장규	장규/NNP
장길	장길/NNP
장덕	장덕/NNP
장래	장래/NNP
장림	장림/NNP
장무	장무/NNP
장보	장보/NNP
장선	장선/NNP
장섭	장섭/NNP
장순	장순/NNP
장열	장열/NNP
장엽	장엽/NNP
장옥	장옥/NNP
장우	장우/NNP
장원	장원/NNP
장일	장일/NNP
장전	장전/NNP
장춘	장춘/NNP
장현	장현/NNP
장호	장호/NNP
장환	장환/NNP
장훈	장훈/NNP
장희	장희/NNP
재각	재각/NNP
재간	재간/NNP
재갑	재갑/NNP
재걸	재걸/NNP
재경	재경/NNP
재곤	재곤/NNP
재관	재관/NNP
재광	재광/NNP
재교	재교/NNP
재구	재구/NNP
재국	재국/NNP
재권	재권/NNP
재규	재규/NNP
재균	재균/NNP
재극	재극/NNP
재근	재근/NNP
재금	재금/NNP
재기	재기/NNP
재길	재길/NNP
재남	재남/NNP
재달	재달/NNP
재당	재당/NNP
재덕	재덕/NNP
재두	재두/NNP
재락	재락/NNP
재령	재령/NNP
재록	재록/NNP
재룡	재룡/NNP
재명	재명/NNP
재모	재모/NNP
재무	재무/NNP
재문	재문/NNP
재민	재민/NNP
재박	재박/NNP
재반	재반/NNP
재방	재방/NNP
재범	재범/NNP
재복	재복/NNP
재봉	재봉/NNP
재붕	재붕/NNP
재빈	재빈/NNP
재삼	재삼/NNP
재생	재생/NNP
재서	재서/NNP
재석	재석/NNP
재선	재선/NNP
재섭	재섭/NNP
재성	재성/NNP
재소	재소/NNP
재수	재수/NNP
재숙	재숙/NNP
재순	재순/NNP
재승	재승/NNP
재신	재신/NNP
재실	재실/NNP
재심	재심/NNP
재양	재양/NNP
재언	재언/NNP
재역	재역/NNP
재연	재연/NNP
재열	재열/NNP
재영	재영/NNP
재오	재오/NNP
재옥	재옥/NNP
재완	재완/NNP
재우	재우/NNP
재욱	재욱/NNP
재웅	재웅/NNP
재원	재원/NNP
재윤	재윤/NNP
재은	재은/NNP
재응	재응/NNP
재익	재익/NNP
재인	재인/NNP
재일	재일/NNP
재정	재정/NNP
재준	재준/NNP
재중	재중/NNP
재진	재진/NNP
재찬	재찬/NNP
재창	재창/NNP
재천	재천/NNP
재철	재철/NNP
재춘	재춘/NNP
재출	재출/NNP
재탁	재탁/NNP
재풍	재풍/NNP
재필	재필/NNP
재학	재학/NNP
재항	재항/NNP
재헌	재헌/NNP
재혁	재혁/NNP
재현	재현/NNP
재형	재형/NNP
재호	재호/NNP
재홍	재홍/NNP
재화	재화/NNP
재환	재환/NNP
재황	재황/NNP
재효	재효/NNP
재후	재후/NNP
재훈	재훈/NNP
재희	재희/NNP
전수	전수/NNP
전순	전순/NNP
전유	전유/NNP
전일	전일/NNP
전항	전항/NNP
전형	전형/NNP
점곤	점곤/NNP
점균	점균/NNP
점두	점두/NNP
점례	점례/NNP
점룡	점룡/NNP
점복	점복/NNP
점선	점선/NNP
점섭	점섭/NNP
점숙	점숙/NNP
점순	점순/NNP
점우	점우/NNP
점혜	점혜/NNP
정갑	정갑/NNP
정구	정구/NNP
정규	정규/NNP
정균	정균/NNP
정근	정근/NNP
정금	정금/NNP
정길	정길/NNP
정남	정남/NNP
정달	정달/NNP
정대	정대/NNP
정덕	정덕/NNP
정래	정래/NNP
정렬	정렬/NNP
정례	정례/NNP
정록	정록/NNP
정림	정림/NNP
정명	정명/NNP
정목	정목/NNP
정무	정무/NNP
정묵	정묵/NNP
정미	정미/NNP
정민	정민/NNP
정배	정배/NNP
정복	정복/NNP
정봉	정봉/NNP
정빈	정빈/NNP
정산	정산/NNP
정삼	정삼/NNP
정선	정선/NNP
정섭	정섭/NNP
정수	정수/NNP
정순	정순/NNP
정실	정실/NNP
정아	정아/NNP
정안	정안/NNP
정애	정애/NNP
정역	정역/NNP
정연	정연/NNP
정엽	정엽/NNP
정영	정영/NNP
정옥	정옥/NNP
정온	정온/NNP
정완	정완/NNP
정우	정우/NNP
정욱	정욱/NNP
정운	정운/NNP
정웅	정웅/NNP
정원	정원/NNP
정윤	정윤/NNP
정인	정인/NNP
정일	정일/NNP
정임	정임/NNP
정자	정자/NNP
정재	정재/NNP
정주	정주/NNP
정중	정중/NNP
정진	정진/NNP
정찬	정찬/NNP
정철	정철/NNP
정춘	정춘/NNP
정태	정태/NNP
정택	정택/NNP
정표	정표/NNP
정하	정하/NNP
정학	정학/NNP
정항	정항/NNP
정향	정향/NNP
정헌	정헌/NNP
정혁	정혁/NNP
정현	정현/NNP
정혜	정혜/NNP
정호	정호/NNP
정화	정화/NNP
정환	정환/NNP
정회	정회/NNP
정효	정효/NNP
정훈	정훈/NNP
정흠	정흠/NNP
정희	정희/NNP
제규	제규/NNP
제균	제균/NNP
제남	제남/NNP
제덕	제덕/NNP
제동	제동/NNP
제옥	제옥/NNP
제완	제완/NNP
제윤	제윤/NNP
제은	제은/NNP
제종	제종/NNP
제준	제준/NNP
제진	제진/NNP
제하	제하/NNP
제한	제한/NNP
제헌	제헌/NNP
제현	제현/NNP
제호	제호/NNP
제홍	제홍/NNP
제효	제효/NNP
제훈	제훈/NNP
조룡	조룡/NNP
조병	조병/NNP
조순	조순/NNP
조연	조연/NNP
조열	조열/NNP
조영	조영/NNP
조웅	조웅/NNP
조한	조한/NNP
종갑	종갑/NNP
종건	종건/NNP
종걸	종걸/NNP
종경	종경/NNP
종관	종관/NNP
종광	종광/NNP
종구	종구/NNP
종국	종국/NNP
종권	종권/NNP
종규	종규/NNP
종균	종균/NNP
종근	종근/NNP
종기	종기/NNP
종길	종길/NNP
종남	종남/NNP
종대	종대/NNP
종덕	종덕/NNP
종두	종두/NNP
종득	종득/NNP
종락	종락/NNP
종래	종래/NNP
종렬	종렬/NNP
종령	종령/NNP
종례	종례/NNP
종록	종록/NNP
종률	종률/NNP
종명	종명/NNP
종모	종모/NNP
종무	종무/NNP
종묵	종묵/NNP
종문	종문/NNP
종미	종미/NNP
종민	종민/NNP
종박	종박/NNP
종배	종배/NNP
종백	종백/NNP
종범	종범/NNP
종복	종복/NNP
종봉	종봉/NNP
종비	종비/NNP
종빈	종빈/NNP
종삼	종삼/NNP
종상	종상/NNP
종서	종서/NNP
종석	종석/NNP
종선	종선/NNP
종섭	종섭/NNP
종성	종성/NNP
종세	종세/NNP
종수	종수/NNP
종숙	종숙/NNP
종순	종순/NNP
종술	종술/NNP
종승	종승/NNP
종식	종식/NNP
종신	종신/NNP
종실	종실/NNP
종애	종애/NNP
종언	종언/NNP
종연	종연/NNP
종열	종열/NNP
종염	종염/NNP
종엽	종엽/NNP
종영	종영/NNP
종오	종오/NNP
종옥	종옥/NNP
종완	종완/NNP
종우	종우/NNP
종욱	종욱/NNP
종운	종운/NNP
종웅	종웅/NNP
종원	종원/NNP
종윤	종윤/NNP
종익	종익/NNP
종인	종인/NNP
종일	종일/NNP
종제	종제/NNP
종조	종조/NNP
종주	종주/NNP
종준	종준/NNP
종직	종직/NNP
종진	종진/NNP
종찬	종찬/NNP
종창	종창/NNP
종채	종채/NNP
종천	종천/NNP
종철	종철/NNP
종출	종출/NNP
종탁	종탁/NNP
종태	종태/NNP
종택	종택/NNP
종표	종표/NNP
종필	종필/NNP
종하	종하/NNP
종학	종학/NNP
종한	종한/NNP
종헌	종헌/NNP
종혁	종혁/NNP
종현	종현/NNP
종호	종호/NNP
종홍	종홍/NNP
종화	종화/NNP
종환	종환/NNP
종회	종회/NNP
종훈	종훈/NNP
종휘	종휘/NNP
종휴	종휴/NNP
종흔	종흔/NNP
종희	종희/NNP
좌명	좌명/NNP
좌영	좌영/NNP
주걸	주걸/NNP
주경	주경/NNP
주균	주균/NNP
주근	주근/NNP
주남	주남/NNP
주년	주년/NNP
주노	주노/NNP
주대	주대/NNP
주란	주란/NNP
주련	주련/NNP
주룡	주룡/NNP
주미	주미/NNP
주복	주복/NNP
주본	주본/NNP
주봉	주봉/NNP
주상	주상/NNP
주생	주생/NNP
주석	주석/NNP
주선	주선/NNP
주섭	주섭/NNP
주성	주성/NNP
주아	주아/NNP
주언	주언/NNP
주열	주열/NNP
주엽	주엽/NNP
주영	주영/NNP
주원	주원/NNP
주진	주진/NNP
주찬	주찬/NNP
주천	주천/NNP
주철	주철/NNP
주하	주하/NNP
주학	주학/NNP
주항	주항/NNP
주향	주향/NNP
주헌	주헌/NNP
주현	주현/NNP
주형	주형/NNP
주호	주호/NNP
주홍	주홍/NNP
주환	주환/NNP
주희	주희/NNP
죽헌	죽헌/NNP
준건	준건/NNP
준겸	준겸/NNP
준경	준경/NNP
준곤	준곤/NNP
준구	준구/NNP
준규	준규/NNP
준기	준기/NNP
준면	준면/NNP
준명	준명/NNP
준묵	준묵/NNP
준배	준배/NNP
준범	준범/NNP
준병	준병/NNP
준상	준상/NNP
준서	준서/NNP
준석	준석/NNP
준섭	준섭/NNP
준성	준성/NNP
준수	준수/NNP
준승	준승/NNP
준식	준식/NNP
준연	준연/NNP
준엽	준엽/NNP
준영	준영/NNP
준용	준용/NNP
준우	준우/NNP
준욱	준욱/NNP
준웅	준웅/NNP
준원	준원/NNP
준익	준익/NNP
준일	준일/NNP
준철	준철/NNP
준태	준태/NNP
준표	준표/NNP
준하	준하/NNP
준학	준학/NNP
준헌	준헌/NNP
준혁	준혁/NNP
준현	준현/NNP
준협	준협/NNP
준형	준형/NNP
준호	준호/NNP
준홍	준홍/NNP
준화	준화/NNP
준환	준환/NNP
준회	준회/NNP
준훈	준훈/NNP
준희	준희/NNP
중건	중건/NNP
중경	중경/NNP
중곤	중곤/NNP
중구	중구/NNP
중권	중권/NNP
중균	중균/NNP
중근	중근/NNP
중기	중기/NNP
중길	중길/NNP
중돈	중돈/NNP
중렬	중렬/NNP
중록	중록/NNP
중림	중림/NNP
중명	중명/NNP
중발	중발/NNP
중배	중배/NNP
중복	중복/NNP
중부	중부/NNP
중서	중서/NNP
중석	중석/NNP
중섭	중섭/NNP
중성	중성/NNP
중수	중수/NNP
중숙	중숙/NNP
중앙	중앙/NNP
중양	중양/NNP
중언	중언/NNP
중업	중업/NNP
중오	중오/NNP
중원	중원/NNP
중재	중재/NNP
중진	중진/NNP
중태	중태/NNP
중표	중표/NNP
중하	중하/NNP
중행	중행/NNP
중헌	중헌/NNP
중현	중현/NNP
중호	중호/NNP
중화	중화/NNP
중환	중환/NNP
중훈	중훈/NNP
중흠	중흠/NNP
중희	중희/NNP
증렬	증렬/NNP
증현	증현/NNP
지견	지견/NNP
지겸	지겸/NNP
지광	지광/NNP
지근	지근/NNP
지룡	지룡/NNP
지미	지미/NNP
지민	지민/NNP
지석	지석/NNP
지선	지선/NNP
지섭	지섭/NNP
지성	지성/NNP
지수	지수/NNP
지숙	지숙/NNP
지순	지순/NNP
지아	지아/NNP
지영	지영/NNP
지예	지예/NNP
지우	지우/NNP
지은	지은/NNP
지인	지인/NNP
지운	지운/NNP
지웅	지웅/NNP
지원	지원/NNP
지윤	지윤/NNP
지일	지일/NNP
지재	지재/NNP
지정	지정/NNP
지준	지준/NNP
지창	지창/NNP
지철	지철/NNP
지항	지항/NNP
지헌	지헌/NNP
지현	지현/NNP
지혜	지혜/NNP
지호	지호/NNP
지홍	지홍/NNP
지화	지화/NNP
지환	지환/NNP
지황	지황/NNP
지훈	지훈/NNP
지희	지희/NNP
직순	직순/NNP
진각	진각/NNP
진강	진강/NNP
진걸	진걸/NNP
진경	진경/NNP
진관	진관/NNP
진광	진광/NNP
진교	진교/NNP
진구	진구/NNP
진국	진국/NNP
진권	진권/NNP
진규	진규/NNP
진균	진균/NNP
진기	진기/NNP
진길	진길/NNP
진대	진대/NNP
진량	진량/NNP
진록	진록/NNP
진명	진명/NNP
진모	진모/NNP
진무	진무/NNP
진배	진배/NNP
진복	진복/NNP
진봉	진봉/NNP
진분	진분/NNP
진산	진산/NNP
진삼	진삼/NNP
진상	진상/NNP
진석	진석/NNP
진선	진선/NNP
진설	진설/NNP
진섭	진섭/NNP
진성	진성/NNP
진세	진세/NNP
진소	진소/NNP
진솔	진솔/NNP
진수	진수/NNP
진숙	진숙/NNP
진순	진순/NNP
진아	진아/NNP
진애	진애/NNP
진열	진열/NNP
진엽	진엽/NNP
진영	진영/NNP
진오	진오/NNP
진옥	진옥/NNP
진완	진완/NNP
진우	진우/NNP
진욱	진욱/NNP
진웅	진웅/NNP
진원	진원/NNP
진윤	진윤/NNP
진일	진일/NNP
진재	진재/NNP
진주	진주/NNP
진중	진중/NNP
진찬	진찬/NNP
진천	진천/NNP
진철	진철/NNP
진탁	진탁/NNP
진태	진태/NNP
진택	진택/NNP
진표	진표/NNP
진하	진하/NNP
진학	진학/NNP
진한	진한/NNP
진혁	진혁/NNP
진현	진현/NNP
진형	진형/NNP
진호	진호/NNP
진홍	진홍/NNP
진환	진환/NNP
진희	진희/NNP
차균	차균/NNP
차돈	차돈/NNP
차득	차득/NNP
차섭	차섭/NNP
찬구	찬구/NNP
찬국	찬국/NNP
찬규	찬규/NNP
찬기	찬기/NNP
찬미	찬미/NNP
찬민	찬민/NNP
찬법	찬법/NNP
찬보	찬보/NNP
찬삼	찬삼/NNP
찬석	찬석/NNP
찬선	찬선/NNP
찬섭	찬섭/NNP
찬성	찬성/NNP
찬수	찬수/NNP
찬숙	찬숙/NNP
찬순	찬순/NNP
찬승	찬승/NNP
찬식	찬식/NNP
찬심	찬심/NNP
찬엽	찬엽/NNP
찬영	찬영/NNP
찬옥	찬옥/NNP
찬우	찬우/NNP
찬욱	찬욱/NNP
찬운	찬운/NNP
찬웅	찬웅/NNP
찬원	찬원/NNP
찬응	찬응/NNP
찬익	찬익/NNP
찬일	찬일/NNP
찬종	찬종/NNP
찬주	찬주/NNP
찬진	찬진/NNP
찬철	찬철/NNP
찬행	찬행/NNP
찬형	찬형/NNP
찬호	찬호/NNP
찬휘	찬휘/NNP
찬희	찬희/NNP
창거	창거/NNP
창걸	창걸/NNP
창경	창경/NNP
창곤	창곤/NNP
창광	창광/NNP
창구	창구/NNP
창국	창국/NNP
창궁	창궁/NNP
창권	창권/NNP
창규	창규/NNP
창균	창균/NNP
창근	창근/NNP
창금	창금/NNP
창기	창기/NNP
창남	창남/NNP
창님	창님/NNP
창덕	창덕/NNP
창득	창득/NNP
창락	창락/NNP
창래	창래/NNP
창렬	창렬/NNP
창로	창로/NNP
창룡	창룡/NNP
창명	창명/NNP
창목	창목/NNP
창무	창무/NNP
창민	창민/NNP
창배	창배/NNP
창번	창번/NNP
창범	창범/NNP
창병	창병/NNP
창복	창복/NNP
창봉	창봉/NNP
창석	창석/NNP
창선	창선/NNP
창섭	창섭/NNP
창성	창성/NNP
창세	창세/NNP
창송	창송/NNP
창수	창수/NNP
창숙	창숙/NNP
창순	창순/NNP
창술	창술/NNP
창식	창식/NNP
창신	창신/NNP
창심	창심/NNP
창애	창애/NNP
창양	창양/NNP
창언	창언/NNP
창업	창업/NNP
창연	창연/NNP
창열	창열/NNP
창엽	창엽/NNP
창영	창영/NNP
창옥	창옥/NNP
창완	창완/NNP
창우	창우/NNP
창욱	창욱/NNP
창웅	창웅/NNP
창원	창원/NNP
창윤	창윤/NNP
창익	창익/NNP
창일	창일/NNP
창정	창정/NNP
창제	창제/NNP
창조	창조/NNP
창종	창종/NNP
창주	창주/NNP
창준	창준/NNP
창중	창중/NNP
창진	창진/NNP
창천	창천/NNP
창평	창평/NNP
창하	창하/NNP
창학	창학/NNP
창해	창해/NNP
창헌	창헌/NNP
창혁	창혁/NNP
창현	창현/NNP
창호	창호/NNP
창화	창화/NNP
창환	창환/NNP
창회	창회/NNP
창훈	창훈/NNP
창흥	창흥/NNP
창희	창희/NNP
채림	채림/NNP
채무	채무/NNP
채민	채민/NNP
채봉	채봉/NNP
채석	채석/NNP
채선	채선/NNP
채심	채심/NNP
채영	채영/NNP
채원	채원/NNP
채은	채은/NNP
채정	채정/NNP
채주	채주/NNP
채철	채철/NNP
채현	채현/NNP
채호	채호/NNP
채환	채환/NNP
채훈	채훈/NNP
천갑	천갑/NNP
천구	천구/NNP
천규	천규/NNP
천기	천기/NNP
천상	천상/NNP
천석	천석/NNP
천선	천선/NNP
천섭	천섭/NNP
천수	천수/NNP
천실	천실/NNP
천안	천안/NNP
천역	천역/NNP
천영	천영/NNP
천우	천우/NNP
천택	천택/NNP
천혜	천혜/NNP
천호	천호/NNP
천홍	천홍/NNP
천흥	천흥/NNP
천희	천희/NNP
철곤	철곤/NNP
철구	철구/NNP
철국	철국/NNP
철규	철규/NNP
철균	철균/NNP
철문	철문/NNP
철민	철민/NNP
철복	철복/NNP
철봉	철봉/NNP
철상	철상/NNP
철성	철성/NNP
철수	철수/NNP
철순	철순/NNP
철승	철승/NNP
철신	철신/NNP
철언	철언/NNP
철영	철영/NNP
철완	철완/NNP
철우	철우/NNP
철웅	철웅/NNP
철준	철준/NNP
철중	철중/NNP
철진	철진/NNP
철호	철호/NNP
철화	철화/NNP
철환	철환/NNP
철훈	철훈/NNP
청아	청아/NNP
청준	청준/NNP
청호	청호/NNP
초롱	초롱/NNP
초섭	초섭/NNP
초아	초아/NNP
초일	초일/NNP
초현	초현/NNP
초희	초희/NNP
춘광	춘광/NNP
춘구	춘구/NNP
춘근	춘근/NNP
춘길	춘길/NNP
춘덕	춘덕/NNP
춘랑	춘랑/NNP
춘련	춘련/NNP
춘림	춘림/NNP
춘미	춘미/NNP
춘보	춘보/NNP
춘복	춘복/NNP
춘빈	춘빈/NNP
춘삼	춘삼/NNP
춘서	춘서/NNP
춘석	춘석/NNP
춘성	춘성/NNP
춘숙	춘숙/NNP
춘심	춘심/NNP
춘암	춘암/NNP
춘애	춘애/NNP
춘역	춘역/NNP
춘연	춘연/NNP
춘영	춘영/NNP
춘옥	춘옥/NNP
춘완	춘완/NNP
춘원	춘원/NNP
춘익	춘익/NNP
춘자	춘자/NNP
춘재	춘재/NNP
춘추	춘추/NNP
춘택	춘택/NNP
춘표	춘표/NNP
춘풍	춘풍/NNP
춘하	춘하/NNP
춘해	춘해/NNP
춘호	춘호/NNP
춘회	춘회/NNP
춘희	춘희/NNP
충구	충구/NNP
충국	충국/NNP
충근	충근/NNP
충길	충길/NNP
충대	충대/NNP
충래	충래/NNP
충렬	충렬/NNP
충모	충모/NNP
충무	충무/NNP
충민	충민/NNP
충범	충범/NNP
충상	충상/NNP
충수	충수/NNP
충순	충순/NNP
충승	충승/NNP
충식	충식/NNP
충엽	충엽/NNP
충옥	충옥/NNP
충우	충우/NNP
충웅	충웅/NNP
충유	충유/NNP
충일	충일/NNP
충재	충재/NNP
충조	충조/NNP
충준	충준/NNP
충직	충직/NNP
충헌	충헌/NNP
충현	충현/NNP
충호	충호/NNP
충홍	충홍/NNP
충환	충환/NNP
충훈	충훈/NNP
충휘	충휘/NNP
치덕	치덕/NNP
치룡	치룡/NNP
치선	치선/NNP
치성	치성/NNP
치수	치수/NNP
치열	치열/NNP
치영	치영/NNP
치우	치우/NNP
치호	치호/NNP
치훈	치훈/NNP
칠남	칠남/NNP
칠봉	칠봉/NNP
칠성	칠성/NNP
칠우	칠우/NNP
칠준	칠준/NNP
탁번	탁번/NNP
탁호	탁호/NNP
탁환	탁환/NNP
태갑	태갑/NNP
태경	태경/NNP
태곤	태곤/NNP
태관	태관/NNP
태규	태규/NNP
태균	태균/NNP
태근	태근/NNP
태길	태길/NNP
태룡	태룡/NNP
태문	태문/NNP
태병	태병/NNP
태섭	태섭/NNP
태성	태성/NNP
태수	태수/NNP
태숙	태숙/NNP
태순	태순/NNP
태식	태식/NNP
태영	태영/NNP
태옥	태옥/NNP
태완	태완/NNP
태우	태우/NNP
태욱	태욱/NNP
태운	태운/NNP
태웅	태웅/NNP
태원	태원/NNP
태윤	태윤/NNP
태응	태응/NNP
태익	태익/NNP
태인	태인/NNP
태일	태일/NNP
태정	태정/NNP
태제	태제/NNP
태조	태조/NNP
태종	태종/NNP
태주	태주/NNP
태준	태준/NNP
태중	태중/NNP
태지	태지/NNP
태진	태진/NNP
태천	태천/NNP
태철	태철/NNP
태촌	태촌/NNP
태춘	태춘/NNP
태평	태평/NNP
태표	태표/NNP
태하	태하/NNP
태학	태학/NNP
태한	태한/NNP
태헌	태헌/NNP
태혁	태혁/NNP
태현	태현/NNP
태형	태형/NNP
태호	태호/NNP
태홍	태홍/NNP
태화	태화/NNP
태환	태환/NNP
태회	태회/NNP
태훈	태훈/NNP
태흡	태흡/NNP
태흥	태흥/NNP
태희	태희/NNP
택경	택경/NNP
택근	택근/NNP
택기	택기/NNP
택돈	택돈/NNP
택민	택민/NNP
택부	택부/NNP
택상	택상/NNP
택석	택석/NNP
택선	택선/NNP
택성	택성/NNP
택수	택수/NNP
택암	택암/NNP
택영	택영/NNP
택원	택원/NNP
택조	택조/NNP
택주	택주/NNP
택중	택중/NNP
택춘	택춘/NNP
택현	택현/NNP
택희	택희/NNP
풍헌	풍헌/NNP
필곤	필곤/NNP
필교	필교/NNP
필규	필규/NNP
필균	필균/NNP
필근	필근/NNP
필량	필량/NNP
필배	필배/NNP
필상	필상/NNP
필선	필선/NNP
필섭	필섭/NNP
필성	필성/NNP
필영	필영/NNP
필웅	필웅/NNP
필주	필주/NNP
필준	필준/NNP
필천	필천/NNP
필호	필호/NNP
하건	하건/NNP
하경	하경/NNP
하균	하균/NNP
하늬	하늬/NNP
하룡	하룡/NNP
하림	하림/NNP
하성	하성/NNP
하영	하영/NNP
하일	하일/NNP
하정	하정/NNP
하중	하중/NNP
하진	하진/NNP
하철	하철/NNP
하춘	하춘/NNP
하희	하희/NNP
학경	학경/NNP
학규	학규/NNP
학균	학균/NNP
학근	학근/NNP
학기	학기/NNP
학남	학남/NNP
학래	학래/NNP
학련	학련/NNP
학모	학모/NNP
학범	학범/NNP
학봉	학봉/NNP
학선	학선/NNP
학섭	학섭/NNP
학성	학성/NNP
학세	학세/NNP
학송	학송/NNP
학수	학수/NNP
학순	학순/NNP
학영	학영/NNP
학윤	학윤/NNP
학재	학재/NNP
학주	학주/NNP
학준	학준/NNP
학중	학중/NNP
학진	학진/NNP
학철	학철/NNP
한경	한경/NNP
한곤	한곤/NNP
한구	한구/NNP
한국	한국/NNP
한규	한규/NNP
한근	한근/NNP
한기	한기/NNP
한길	한길/NNP
한나	한나/NNP
한련	한련/NNP
한룡	한룡/NNP
한민	한민/NNP
한범	한범/NNP
한봉	한봉/NNP
한빈	한빈/NNP
한빛	한빛/NNP
한상	한상/NNP
한샘	한샘/NNP
한석	한석/NNP
한선	한선/NNP
한섭	한섭/NNP
한성	한성/NNP
한솔	한솔/NNP
한수	한수/NNP
한숙	한숙/NNP
한승	한승/NNP
한열	한열/NNP
한엽	한엽/NNP
한영	한영/NNP
한오	한오/NNP
한우	한우/NNP
한욱	한욱/NNP
한웅	한웅/NNP
한원	한원/NNP
한음	한음/NNP
한익	한익/NNP
한정	한정/NNP
한조	한조/NNP
한주	한주/NNP
한준	한준/NNP
한직	한직/NNP
한진	한진/NNP
한집	한집/NNP
한천	한천/NNP
한철	한철/NNP
한춘	한춘/NNP
한탁	한탁/NNP
한택	한택/NNP
한필	한필/NNP
한호	한호/NNP
한흠	한흠/NNP
한희	한희/NNP
항경	항경/NNP
항구	항구/NNP
항규	항규/NNP
항기	항기/NNP
항노	항노/NNP
항덕	항덕/NNP
항래	항래/NNP
항렬	항렬/NNP
항석	항석/NNP
항수	항수/NNP
항주	항주/NNP
항준	항준/NNP
해규	해규/NNP
해근	해근/NNP
해남	해남/NNP
해란	해란/NNP
해룡	해룡/NNP
해미	해미/NNP
해민	해민/NNP
해범	해범/NNP
해봉	해봉/NNP
해부	해부/NNP
해석	해석/NNP
해선	해선/NNP
해성	해성/NNP
해수	해수/NNP
해숙	해숙/NNP
해심	해심/NNP
해엽	해엽/NNP
해영	해영/NNP
해옥	해옥/NNP
해욱	해욱/NNP
해원	해원/NNP
해월	해월/NNP
해은	해은/NNP
해인	해인/NNP
해일	해일/NNP
해임	해임/NNP
해자	해자/NNP
해전	해전/NNP
해정	해정/NNP
해조	해조/NNP
해종	해종/NNP
해주	해주/NNP
해준	해준/NNP
해진	해진/NNP
해찬	해찬/NNP
해창	해창/NNP
해철	해철/NNP
해통	해통/NNP
해현	해현/NNP
해호	해호/NNP
해효	해효/NNP
행규	행규/NNP
행균	행균/NNP
행길	행길/NNP
행남	행남/NNP
행덕	행덕/NNP
행수	행수/NNP
행연	행연/NNP
행우	행우/NNP
행일	행일/NNP
행지	행지/NNP
행철	행철/NNP
향덕	향덕/NNP
향란	향란/NNP
향련	향련/NNP
향록	향록/NNP
향미	향미/NNP
향배	향배/NNP
향백	향백/NNP
향설	향설/NNP
향숙	향숙/NNP
향순	향순/NNP
향아	향아/NNP
향열	향열/NNP
향옥	향옥/NNP
향우	향우/NNP
향자	향자/NNP
향전	향전/NNP
향지	향지/NNP
향진	향진/NNP
향초	향초/NNP
향희	향희/NNP
헌규	헌규/NNP
헌기	헌기/NNP
헌길	헌길/NNP
헌무	헌무/NNP
헌문	헌문/NNP
헌상	헌상/NNP
헌석	헌석/NNP
헌선	헌선/NNP
헌성	헌성/NNP
헌수	헌수/NNP
헌식	헌식/NNP
헌열	헌열/NNP
헌영	헌영/NNP
헌재	헌재/NNP
헌정	헌정/NNP
헌주	헌주/NNP
헌태	헌태/NNP
헌표	헌표/NNP
헌호	헌호/NNP
헤걸	헤걸/NNP
혁규	혁규/NNP
혁기	혁기/NNP
혁래	혁래/NNP
혁림	혁림/NNP
혁백	혁백/NNP
혁범	혁범/NNP
혁빈	혁빈/NNP
혁송	혁송/NNP
혁수	혁수/NNP
혁인	혁인/NNP
혁재	혁재/NNP
혁종	혁종/NNP
혁주	혁주/NNP
혁준	혁준/NNP
혁진	혁진/NNP
혁찬	혁찬/NNP
혁철	혁철/NNP
혁호	혁호/NNP
현갑	현갑/NNP
현강	현강/NNP
현경	현경/NNP
현곤	현곤/NNP
현구	현구/NNP
현국	현국/NNP
현궁	현궁/NNP
현규	현규/NNP
현균	현균/NNP
현기	현기/NNP
현길	현길/NNP
현대	현대/NNP
현덕	현덕/NNP
현두	현두/NNP
현락	현락/NNP
현룡	현룡/NNP
현림	현림/NNP
현목	현목/NNP
현무	현무/NNP
현묵	현묵/NNP
현문	현문/NNP
현미	현미/NNP
현민	현민/NNP
현배	현배/NNP
현백	현백/NNP
현범	현범/NNP
현보	현보/NNP
현복	현복/NNP
현부	현부/NNP
현산	현산/NNP
현상	현상/NNP
현서	현서/NNP
현석	현석/NNP
현선	현선/NNP
현섭	현섭/NNP
현성	현성/NNP
현세	현세/NNP
현수	현수/NNP
현숙	현숙/NNP
현순	현순/NNP
현승	현승/NNP
현식	현식/NNP
현실	현실/NNP
현심	현심/NNP
현아	현아/NNP
현연	현연/NNP
현영	현영/NNP
현옥	현옥/NNP
현우	현우/NNP
현욱	현욱/NNP
현웅	현웅/NNP
현유	현유/NNP
현익	현익/NNP
현일	현일/NNP
현재	현재/NNP
현정	현정/NNP
현제	현제/NNP
현조	현조/NNP
현종	현종/NNP
현주	현주/NNP
현준	현준/NNP
현중	현중/NNP
현지	현지/NNP
현진	현진/NNP
현채	현채/NNP
현철	현철/NNP
현태	현태/NNP
현택	현택/NNP
현파	현파/NNP
현표	현표/NNP
현풍	현풍/NNP
현호	현호/NNP
현화	현화/NNP
현희	현희/NNP
형각	형각/NNP
형경	형경/NNP
형곤	형곤/NNP
형광	형광/NNP
형구	형구/NNP
형국	형국/NNP
형권	형권/NNP
형규	형규/NNP
형균	형균/NNP
형근	형근/NNP
형기	형기/NNP
형길	형길/NNP
형남	형남/NNP
형대	형대/NNP
형두	형두/NNP
형락	형락/NNP
형래	형래/NNP
형량	형량/NNP
형룡	형룡/NNP
형모	형모/NNP
형무	형무/NNP
형민	형민/NNP
형배	형배/NNP
형벽	형벽/NNP
형보	형보/NNP
형산	형산/NNP
형상	형상/NNP
형석	형석/NNP
형선	형선/NNP
형섭	형섭/NNP
형수	형수/NNP
형숙	형숙/NNP
형순	형순/NNP
형식	형식/NNP
형실	형실/NNP
형영	형영/NNP
형오	형오/NNP
형옥	형옥/NNP
형우	형우/NNP
형욱	형욱/NNP
형원	형원/NNP
형인	형인/NNP
형일	형일/NNP
형자	형자/NNP
형주	형주/NNP
형준	형준/NNP
형중	형중/NNP
형직	형직/NNP
형진	형진/NNP
형찬	형찬/NNP
형철	형철/NNP
형태	형태/NNP
형택	형택/NNP
형표	형표/NNP
형필	형필/NNP
형호	형호/NNP
형환	형환/NNP
형효	형효/NNP
형희	형희/NNP
혜걸	혜걸/NNP
혜경	혜경/NNP
혜교	혜교/NNP
혜구	혜구/NNP
혜란	혜란/NNP
혜련	혜련/NNP
혜령	혜령/NNP
혜룡	혜룡/NNP
혜린	혜린/NNP
혜림	혜림/NNP
혜명	혜명/NNP
혜미	혜미/NNP
혜민	혜민/NNP
혜상	혜상/NNP
혜선	혜선/NNP
혜성	혜성/NNP
혜수	혜수/NNP
혜숙	혜숙/NNP
혜순	혜순/NNP
혜식	혜식/NNP
혜신	혜신/NNP
혜실	혜실/NNP
혜심	혜심/NNP
혜연	혜연/NNP
혜영	혜영/NNP
혜옥	혜옥/NNP
혜우	혜우/NNP
혜원	혜원/NNP
혜윤	혜윤/NNP
혜인	혜인/NNP
혜자	혜자/NNP
혜전	혜전/NNP
혜정	혜정/NNP
혜주	혜주/NNP
혜준	혜준/NNP
혜지	혜지/NNP
혜진	혜진/NNP
혜천	혜천/NNP
호갑	호갑/NNP
호겸	호겸/NNP
호경	호경/NNP
호곤	호곤/NNP
호교	호교/NNP
호규	호규/NNP
호균	호균/NNP
호근	호근/NNP
호길	호길/NNP
호덕	호덕/NNP
호령	호령/NNP
호림	호림/NNP
호민	호민/NNP
호배	호배/NNP
호범	호범/NNP
호상	호상/NNP
호석	호석/NNP
호선	호선/NNP
호섭	호섭/NNP
호성	호성/NNP
호수	호수/NNP
호숙	호숙/NNP
호순	호순/NNP
호승	호승/NNP
호신	호신/NNP
호연	호연/NNP
호영	호영/NNP
호완	호완/NNP
호우	호우/NNP
호웅	호웅/NNP
호원	호원/NNP
호인	호인/NNP
호일	호일/NNP
호정	호정/NNP
호준	호준/NNP
호중	호중/NNP
호직	호직/NNP
호진	호진/NNP
호철	호철/NNP
호태	호태/NNP
호택	호택/NNP
호현	호현/NNP
홍거	홍거/NNP
홍건	홍건/NNP
홍걸	홍걸/NNP
홍교	홍교/NNP
홍구	홍구/NNP
홍규	홍규/NNP
홍균	홍균/NNP
홍근	홍근/NNP
홍기	홍기/NNP
홍길	홍길/NNP
홍남	홍남/NNP
홍내	홍내/NNP
홍란	홍란/NNP
홍래	홍래/NNP
홍렬	홍렬/NNP
홍록	홍록/NNP
홍명	홍명/NNP
홍무	홍무/NNP
홍민	홍민/NNP
홍배	홍배/NNP
홍범	홍범/NNP
홍빈	홍빈/NNP
홍석	홍석/NNP
홍섭	홍섭/NNP
홍수	홍수/NNP
홍숙	홍숙/NNP
홍순	홍순/NNP
홍식	홍식/NNP
홍신	홍신/NNP
홍업	홍업/NNP
홍열	홍열/NNP
홍엽	홍엽/NNP
홍우	홍우/NNP
홍운	홍운/NNP
홍원	홍원/NNP
홍인	홍인/NNP
홍일	홍일/NNP
홍재	홍재/NNP
홍조	홍조/NNP
홍주	홍주/NNP
홍준	홍준/NNP
홍진	홍진/NNP
홍집	홍집/NNP
홍창	홍창/NNP
홍천	홍천/NNP
홍철	홍철/NNP
홍탁	홍탁/NNP
홍택	홍택/NNP
홍한	홍한/NNP
홍훈	홍훈/NNP
홍희	홍희/NNP
화강	화강/NNP
화경	화경/NNP
화균	화균/NNP
화선	화선/NNP
화성	화성/NNP
화순	화순/NNP
화신	화신/NNP
화영	화영/NNP
화익	화익/NNP
화정	화정/NNP
화중	화중/NNP
화진	화진/NNP
화청	화청/NNP
환구	환구/NNP
환규	환규/NNP
환균	환균/NNP
환기	환기/NNP
환문	환문/NNP
환빈	환빈/NNP
환신	환신/NNP
환열	환열/NNP
환익	환익/NNP
환일	환일/NNP
환준	환준/NNP
환태	환태/NNP
활란	활란/NNP
황경	황경/NNP
황규	황규/NNP
황식	황식/NNP
황인	황인/NNP
황진	황진/NNP
황희	황희/NNP
회광	회광/NNP
회남	회남/NNP
회성	회성/NNP
회수	회수/NNP
회승	회승/NNP
회운	회운/NNP
회익	회익/NNP
회재	회재/NNP
회창	회창/NNP
회택	회택/NNP
효경	효경/NNP
효관	효관/NNP
효근	효근/NNP
효남	효남/NNP
효래	효래/NNP
효량	효량/NNP
효림	효림/NNP
효명	효명/NNP
효목	효목/NNP
효문	효문/NNP
효민	효민/NNP
효백	효백/NNP
효범	효범/NNP
효빈	효빈/NNP
효상	효상/NNP
효석	효석/NNP
효선	효선/NNP
효섭	효섭/NNP
효성	효성/NNP
효손	효손/NNP
효수	효수/NNP
효숙	효숙/NNP
효순	효순/NNP
효식	효식/NNP
효신	효신/NNP
효실	효실/NNP
효심	효심/NNP
효열	효열/NNP
효영	효영/NNP
효원	효원/NNP
효은	효은/NNP
효익	효익/NNP
효인	효인/NNP
효재	효재/NNP
효정	효정/NNP
효제	효제/NNP
효종	효종/NNP
효준	효준/NNP
효중	효중/NNP
효지	효지/NNP
효진	효진/NNP
효철	효철/NNP
효춘	효춘/NNP
효택	효택/NNP
효현	효현/NNP
효환	효환/NNP
효훈	효훈/NNP
후길	후길/NNP
후남	후남/NNP
후덕	후덕/NNP
훈구	훈구/NNP
훈국	훈국/NNP
훈기	훈기/NNP
훈당	훈당/NNP
훈범	훈범/NNP
훈상	훈상/NNP
훈석	훈석/NNP
훈식	훈식/NNP
훈종	훈종/NNP
훈태	훈태/NNP
훈택	훈택/NNP
훈현	훈현/NNP
휘경	휘경/NNP
휘산	휘산/NNP
휘성	휘성/NNP
휘영	휘영/NNP
휘윤	휘윤/NNP
휘재	휘재/NNP
휘준	휘준/NNP
휘철	휘철/NNP
휘칠	휘칠/NNP
휴나	휴나/NNP
휴정	휴정/NNP
흔탁	흔탁/NNP
흠돌	흠돌/NNP
흠순	흠순/NNP
흠운	흠운/NNP
흠조	흠조/NNP
흥구	흥구/NNP
흥국	흥국/NNP
흥규	흥규/NNP
흥기	흥기/NNP
흥길	흥길/NNP
흥래	흥래/NNP
흥렬	흥렬/NNP
흥록	흥록/NNP
흥문	흥문/NNP
흥미	흥미/NNP
흥복	흥복/NNP
흥산	흥산/NNP
흥수	흥수/NNP
흥순	흥순/NNP
흥식	흥식/NNP
흥신	흥신/NNP
흥실	흥실/NNP
흥원	흥원/NNP
흥윤	흥윤/NNP
흥주	흥주/NNP
흥준	흥준/NNP
흥진	흥진/NNP
흥촌	흥촌/NNP
흥태	흥태/NNP
흥호	흥호/NNP
희갑	희갑/NNP
희강	희강/NNP
희건	희건/NNP
희경	희경/NNP
희관	희관/NNP
희국	희국/NNP
희권	희권/NNP
희규	희규/NNP
희균	희균/NNP
희근	희근/NNP
희덕	희덕/NNP
희락	희락/NNP
희량	희량/NNP
희련	희련/NNP
희문	희문/NNP
희범	희범/NNP
희병	희병/NNP
희복	희복/NNP
희분	희분/NNP
희상	희상/NNP
희서	희서/NNP
희석	희석/NNP
희선	희선/NNP
희섭	희섭/NNP
희성	희성/NNP
희수	희수/NNP
희숙	희숙/NNP
희순	희순/NNP
희승	희승/NNP
희식	희식/NNP
희암	희암/NNP
희애	희애/NNP
희연	희연/NNP
희영	희영/NNP
희옥	희옥/NNP
희완	희완/NNP
희웅	희웅/NNP
희원	희원/NNP
희윤	희윤/NNP
희은	희은/NNP
희인	희인/NNP
희일	희일/NNP
희자	희자/NNP
희장	희장/NNP
희재	희재/NNP
희정	희정/NNP
희제	희제/NNP
희조	희조/NNP
희주	희주/NNP
희준	희준/NNP
희중	희중/NNP
희진	희진/NNP
희집	희집/NNP
희찬	희찬/NNP
희창	희창/NNP
희천	희천/NNP
희철	희철/NNP
희춘	희춘/NNP
희태	희태/NNP
희택	희택/NNP
희평	희평/NNP
희표	희표/NNP
희현	희현/NNP
희호	희호/NNP
희환	희환/NNP
희흠	희흠/NNP
